
LIBOR SZTEMON'S CZECH-PERSIAN WORD LIST

20. �nor - 20. b�ezen	Espand
21. b�ezen - 20. duben	Farvardin
21. duben - 21. kv�ten	Ordibehe�t
21. leden - 19. �nor	Bahman
22. kv�ten - 21. �erven	Xord�d
22. listopad - 21. prosinec	�zar
22. prosinec - 20. leden	Dey
23. �ervenec - 22. srpen	Amord�d
23. ��jen - 21. listopad	�b�n
23. srpen - 22. z���	�ahrivar
a	va, o
abeceda	alefb�
adresa	�dres, ne��ni
adres��	daftar e ne��ni
Afgh�nist�n	Afq�nest�n
ahoj	sal�m, dorud
ach!	�h!
akreditiv	e'teb�rn�me
aksamit	maxmali
Alb�nie	�lb�ni
album	�lbum
ale	joz, vali
alej	kuceh
alergie	�ler�i
alibi	bah�ne
almanach	s�ln�me
alpsk�	�lpi
Alpy	kuhh� ye �lp
Amerika	Emrik�
ametyst	y�qut e rom�ni
ananas	�n�n�s
an�ovi�ka	m�hi ye kuli
and�l	faravahr, fere�te
anekdota	�uxi
ang�na	bar�madegi ye lowze
anglick�	engelisi
angre�t	angur e farangi
ani	hati, hic
ano	�ri, bale, �re
antibiotick�	�ntibiyotik
antibiotikum	�ntibiyotik
antick�	atiqe
antikoncepce	d�ru ye zedd e �bestani
antiseptick�	zedd e ofuni
apartm�	�abest�n
apendix	�p�ndis
aperitiv	pi�p�re
aplaudovat	sotudan, �farin goftan, kaf zadan
Arab	Arab
Arabov�	Ar�b
arabsk�	arabi
aran�ovat	cidan
Argentina	Ar��ntin
arch	varaq
archeolog	b�st�n�en�s
archeologie	b�st�n�en�si
architekt	�r�itekt
archiv	�r�iv
�rijsk�	�ry�yi
arm�da	la�gar, arte�, sep�h
aroma	bu ye xo�
art�rie	��hrag
artista	honarpi�e
artritida	b�d e maf�sel
artr�za	�rtroz
arty�ok	�rti�o
asi	gerd�gerd, ��yad
aspirin	�sprin
astronom	set�re�en�s
astronomie	set�re�en�si
a� byl	bude b�
a� byl d�l�n	karde �ode b�ad
a� byli	bude b�and
a� byli d�l�ni	karde �ode b�and
a� d�v�	bedehad
a� d�vaj�	bedehand
a� d�val	d�de b�
a� d�vali	d�de b�and
a� d�v�m	bedeham
a� d�v�me	bedehim
a� d�v�	bedehi
a� d�v�te	bedehid
a� d�l�	bekonad
a� d�laj�	bekonand
a� d�lal	karde b�
a� d�lali	karde b�and
a� d�l�m	bekonam
a� d�l�me	bekonim
a� d�l�	bekoni
a� d�l�te	bekonid
a� hraje	b�zi bekonad
a� hrajeme	b�zi bekonim
a� hraje�	b�zi bekoni
a� hrajete	b�zi bekonid
a� hraji	b�zi bekonam
a� hraj�	b�zi bekonand
a� hr�l	b�zi karde b�
a� hr�li	b�zi karde b�and
a� chce	bex�had
a� chceme	bex�him
a� chce�	bex�hi
a� chcete	bex�hid
a� chci	bex�ham
a� cht�j�	bex�hand
a� cht�l	x�ste b�
a� cht�li	x�ste b�and
a� jde	beravad
a� jdeme	beravim
a� jde�	beravi
a� jdete	beravid
a� jdou	beravand
a� jdu	beravam
a� je	b�ad
a� je d�l�n	karde be�avad
a� jed�	bex�rand
a� jedl	xorde b�
a� jedli	xorde b�and
a� j�	bex�rad
a� j�m	bex�ram
a� j�me	bex�rim
a� j�	bex�ri
a� j�te	bex�rid
a� jsem	b�am
a� jsem byl	bude b�am
a� jsem byl d�l�n	karde �ode b�am
a� jsem d�val	d�de b�am
a� jsem d�lal	karde b�am
a� jsem d�l�n	karde be�avam
a� jsem hr�l	b�zi karde b�am
a� jsem cht�l	x�ste b�am
a� jsem jedl	xorde b�am
a� jsem l�mal	�ekaste b�am
a� jsem m�l	d�te b�am
a� jsem nebyl	nabude b�am
a� jsem nebyl d�l�n	karde �ode nab�am
a� jsem ned�val	nad�de b�am
a� jsem ned�lal	nakarde b�am
a� jsem nehr�l	b�zi nakarde b�am
a� jsem necht�l	nax�ste b�am
a� jsem nejedl	naxorde b�am
a� jsem nepil	nay��mide b�am
a� jsem nepo��tal	na�omorde b�am
a� jsem nep�inesl	nay�varde b�am
a� jsem nep�i�el	nay�made b�am
a� jsem nespal	nax�bide b�am
a� jsem nev�d�l	nad�neste b�am
a� jsem nezav�ral	nabaste b�am
a� jsem pil	��mide b�am
a� jsem po��tal	�omorde b�am
a� jsem p�inesl	�varde b�am
a� jsem p�i�el	�made b�am
a� jsem �ezal	borde b�am
a� jsem spal	x�bide b�am
a� jsem v�d�l	d�neste b�am
a� jsem zav�ral	baste b�am
a� jsi	b�i
a� jsi byl	bude b�i
a� jsi byl d�l�n	karde �ode b�i
a� jsi d�val	d�de b�i
a� jsi d�lal	karde b�i
a� jsi d�l�n	karde be�avi
a� jsi hr�l	b�zi karde b�i
a� jsi cht�l	x�ste b�i
a� jsi jedl	xorde b�i
a� jsi l�mal	�ekaste b�i
a� jsi m�l	d�te b�i
a� jsi nebyl	nabude b�i
a� jsi nebyl d�l�n	karde �ode nab�i
a� jsi ned�val	nad�de b�i
a� jsi ned�lal	nakarde b�i
a� jsi nehr�l	b�zi nakarde b�i
a� jsi necht�l	nax�ste b�i
a� jsi nejedl	naxorde b�i
a� jsi nepil	nay��mide b�i
a� jsi nepo��tal	na�omorde b�i
a� jsi nep�inesl	nay�varde b�i
a� jsi nep�i�el	nay�made b�i
a� jsi nespal	nax�bide b�i
a� jsi nev�d�l	nad�neste b�i
a� jsi nezav�ral	nabaste b�i
a� jsi pil	��mide b�i
a� jsi po��tal	�omorde b�i
a� jsi p�inesl	�varde b�i
a� jsi p�i�el	�made b�i
a� jsi �ezal	borde b�i
a� jsi spal	x�bide b�i
a� jsi v�d�l	d�neste b�i
a� jsi zav�ral	baste b�i
a� jsme	b�im
a� jsme byli	bude b�im
a� jsme byli d�l�ni	karde �ode b�im
a� jsme d�vali	d�de b�im
a� jsme d�lali	karde b�im
a� jsme d�l�ni	karde be�avim
a� jsme hr�li	b�zi karde b�im
a� jsme cht�li	x�ste b�im
a� jsme jedli	xorde b�im
a� jsme l�mali	�ekaste b�im
a� jsme m�li	d�te b�im
a� jsme nebyli	nabude b�im
a� jsme nebyli d�l�ni	karde �ode nab�im
a� jsme ned�vali	nad�de b�im
a� jsme ned�lali	nakarde b�im
a� jsme nehr�li	b�zi nakarde b�im
a� jsme necht�li	nax�ste b�im
a� jsme nejedli	naxorde b�im
a� jsme nepili	nay��mide b�im
a� jsme nepo��tali	na�omorde b�im
a� jsme nep�inesli	nay�varde b�im
a� jsme nep�i�li	nay�made b�im
a� jsme nespali	nax�bide b�im
a� jsme nev�d�li	nad�neste b�im
a� jsme nezav�rali	nabaste b�im
a� jsme pili	��mide b�im
a� jsme po��tali	�omorde b�im
a� jsme p�inesli	�varde b�im
a� jsme p�i�li	�made b�im
a� jsme �ezali	borde b�im
a� jsme spali	x�bide b�im
a� jsme v�d�li	d�neste b�im
a� jsme zav�rali	baste b�im
a� jsou	b�and
a� jsou d�l�ni	karde be�avand
a� jste	b�id
a� jste byli	bude b�id
a� jste byli d�l�ni	karde �ode b�id
a� jste d�vali	d�de b�id
a� jste d�lali	karde b�id
a� jste d�l�ni	karde be�avid
a� jste hr�li	b�zi karde b�id
a� jste cht�li	x�ste b�id
a� jste jedli	xorde b�id
a� jste l�mali	�ekaste b�id
a� jste m�li	d�te b�im, d�te b�id
a� jste nebyli	nabude b�id
a� jste nebyli d�l�ni	karde �ode nab�id
a� jste ned�vali	nad�de b�id
a� jste ned�lali	nakarde b�id
a� jste nehr�li	b�zi nakarde b�id
a� jste necht�li	nax�ste b�id
a� jste nejedli	naxorde b�id
a� jste nepili	nay��mide b�id
a� jste nepo��tali	na�omorde b�id
a� jste nep�inesli	nay�varde b�id
a� jste nep�i�li	nay�made b�id
a� jste nespali	nax�bide b�id
a� jste nev�d�li	nad�neste b�id
a� jste nezav�rali	nabaste b�id
a� jste pili	��mide b�id
a� jste po��tali	�omorde b�id
a� jste p�inesli	�varde b�id
a� jste p�i�li	�made b�id
a� jste �ezali	borde b�id
a� jste spali	x�bide b�id
a� jste v�d�li	d�neste b�id
a� jste zav�rali	baste b�id
a� l�mal	�ekaste b�
a� l�mali	�ekaste b�and
a� l�me	be�ekandad
a� l�meme	be�ekandim
a� l�me�	be�ekandi
a� l�mete	be�ekandid
a� l�mou	be�ekandand
a� l�mu	be�ekandam
a� m�l	d�te b�
a� m�li	d�te b�and
a� nebyl	nabude b�
a� nebyl d�l�n	karde �ode nab�ad
a� nebyli	nabude b�and
a� nebyli d�l�ni	karde �ode nab�and
a� ned�v�	nadehad
a� ned�vaj�	nadehand
a� ned�val	nad�de b�
a� ned�vali	nad�de b�and
a� ned�v�m	nadeham
a� ned�v�me	nadehim
a� ned�v�	nadehi
a� ned�v�te	nadehid
a� ned�l�	nakonad
a� ned�laj�	nakonand
a� ned�lal	nakarde b�
a� ned�lali	nakarde b�and
a� ned�l�m	nakonam
a� ned�l�me	nakonim
a� ned�l�	nakoni
a� ned�l�te	nakonid
a� nehraje	b�zi nakonad
a� nehrajeme	b�zi nakonim
a� nehraje�	b�zi nakoni
a� nehrajete	b�zi nakonid
a� nehraji	b�zi nakonam
a� nehraj�	b�zi nakonand
a� nehr�l	b�zi nakarde b�
a� nehr�li	b�zi nakarde b�and
a� nechce	nax�had
a� nechceme	nax�him
a� nechce�	nax�hi
a� nechcete	nax�hid
a� nechci	nax�ham
a� necht�j�	nax�hand
a� necht�l	nax�ste b�
a� necht�li	nax�ste b�and
a� nejed�	nax�rand
a� nejedl	naxorde b�
a� nejedli	naxorde b�and
a� nej�	nax�rad
a� nej�m	nax�ram
a� nej�me	nax�rim
a� nej�	nax�ri
a� nej�te	nax�rid
a� nejsem	nab�am
a� nejsem d�l�n	karde na�avam
a� nejsi	nab�i
a� nejsi d�l�n	karde na�avi
a� nejsme	nab�im
a� nejsme d�l�ni	karde na�avim
a� nejsou	nab�and
a� nejsou d�l�ni	karde na�avand
a� nejste	nab�id
a� nejste d�l�ni	karde na�avid
a� nen�	nab�ad
a� nen� d�l�n	karde na�avad
a� nepije	nay��mad
a� nepijeme	nay��mim
a� nepije�	nay��mi
a� nepijete	nay��mid
a� nepiji	nay��mam
a� nepij�	nay��mand
a� nepil	nay��mide b�
a� nepili	nay��mide b�and
a� nepo��t�	na�omorad
a� nepo��taj�	na�omorand
a� nepo��tal	na�omorde b�
a� nepo��tali	na�omorde b�and
a� nepo��t�m	na�omoram
a� nepo��t�me	na�omorim
a� nepo��t�	na�omori
a� nepo��t�te	na�omorid
a� nep�ich�zej�	nay�yand
a� nep�ich�z�	nay�yam, nay�yad
a� nep�ich�z�me	nay�'im
a� nep�ich�z�	nay�'i
a� nep�ich�z�te	nay�'id
a� nep�in�ej�	nay�rand
a� nep�in��	nay�rad
a� nep�in��m	nay�ram
a� nep�in��me	nay�rim
a� nep�in��	nay�ri
a� nep�in��te	nay�rid
a� nep�inesl	nay�varde b�
a� nep�inesli	nay�varde b�and
a� nep�i�el	nay�made b�
a� nep�i�li	nay�made b�and
a� nespal	nax�bide b�
a� nespali	nax�bide b�and
a� nesp�	nax�bad
a� nesp� (pl.)	nax�band
a� nesp�m	nax�bam
a� nesp�me	nax�bim
a� nesp�	nax�bi
a� nesp�te	nax�bid
a� nev�d�l	nad�neste b�
a� nev�d�li	nad�neste b�and
a� nev�d�	nad�nand
a� nev�	nad�nad
a� nev�m	nad�nam
a� nev�me	nad�nim
a� nev�	nad�ni
a� nev�te	nad�nid
a� nezav�r�	nabandad
a� nezav�raj�	nabandand
a� nezav�ral	nabaste b�
a� nezav�rali	nabaste b�and
a� nezav�r�m	nabandam
a� nezav�r�me	nabandim
a� nezav�r�	nabandi
a� nezav�r�te	nabandid
a� pije	x�had ��mid
a� pijeme	x�him ��mid
a� pije�	x�hi ��mid
a� pijete	x�hid ��mid
a� piji	x�ham ��mid
a� pij�	x�hand ��mid
a� pil	��mide b�
a� pili	��mide b�and
a� po��t�	be�omorad
a� po��taj�	be�omorand
a� po��tal	�omorde b�
a� po��tali	�omorde b�and
a� po��t�m	be�omoram
a� po��t�me	be�omorim
a� po��t�	be�omori
a� po��t�te	be�omorid
a� p�ich�zej�	be�yand
a� p�ich�z�	be�yad
a� p�ich�z�m	be�yam
a� p�ich�z�me	be�'im
a� p�ich�z�	be�'i
a� p�ich�z�te	be�'id
a� p�in�ej�	be�rand
a� p�in��	be�rad
a� p�in��m	be�ram
a� p�in��me	be�rim
a� p�in��	be�ri
a� p�in��te	be�rid
a� p�inesl	�varde b�
a� p�inesli	�varde b�and
a� p�i�el	�made b�
a� p�i�li	�made b�and
a� �ez�	bebarad
a� �ezaj�	bebarand
a� �ezal	borde b�
a� �ezali	borde b�and
a� �ez�m	bebaram
a� �ez�me	bebarim
a� �ez�	bebari
a� �ez�te	bebarid
a� se st�v�	be�avad
a� se st�vaj�	be�avand
a� se st�v�m	be�avam
a� se st�v�me	be�avim
a� se st�v�	be�avi
a� se st�v�te	be�avid
a� spal	x�bide b�
a� spali	x�bide b�and
a� sp�	bex�bad
a� sp� (pl.)	bex�band
a� sp�m	bex�bam
a� sp�me	bex�bim
a� sp�	bex�bi
a� sp�te	bex�bid
a� v�d�l	d�neste b�
a� v�d�li	d�neste b�and
a� v�d�	bed�nand
a� v�	bed�nad
a� vid�	bebinad
a� vid� (pl.)	bebinand
a� vid�m	bebinam
a� vid�me	bebinim
a� vid�	bebini
a� vid�te	bebinid
a� v�m	bed�nam
a� v�me	bed�nim
a� v�	bed�ni
a� v�te	bed�nid
a� zav�r�	bebandad
a� zav�raj�	bebandand
a� zav�ral	baste b�
a� zav�rali	baste b�and
a� zav�r�m	bebandam
a� zav�r�me	bebandim
a� zav�r�	bebandi
a� zav�r�te	bebandid
atmosf�ra	atmosfer
atmosf�rick�	atmosferi
atom	atom
atomov�	atomi
auto	xodrow, m�in
autobus	otobus
autokar	otok�r
automapa	naq�e ye r�hh�
automobil	otomobil
av�ak	joz, amm�
a� (do)	t�
a� do	t� inke, t� �nke
babi�ka	m�darbozorg
bacil	b�sil
ba�kora	damp�yi
ba�kory	joft damp�yi
b�je�n�	b�okuhi
bajka	afs�ne
bakla��n	b�denj�n
bakt�rie	b�kteri
balet	b�le
balic� pap�r	k�qaz e k�do
Balk�n	B�lk�n
balk�nsk�	B�lk�ni
balkon	b�lkon
balon	b�lon
ban�n	mowz
banda	b�nd
banka	b�nk
bank��	b�nkd�r
bankovn�	b�nki
bar	b�r
barevn� tu�ka	qalam e naqq�i, qalam
barevn�	rangi, rangin
barevn� p�eliv	rangbar
barokn�	b�roki
baroko	b�rok
barva	rang
b�sn�ci	�o'ar�
b�t se	tarsidan
baterie	b�tri
bavlna	panbe, kat�n
bazar	b�z�r
baz�n	estaxr
b�zliv�	tarsu
ba�ant	qarq�vol
ba�ina	siy�h�b, mord�b
bedna	sandoq
begonie	begoniy�
b�hat	davidan
b�hem	darbeyn
belgick�	Bel�iki
Belgie	Bel�ik
benzin	benzin
benzinov� �erpac� stanice	pomp e benzin
benzinov� pumpa	pomp e benzin
ber	bebar
ber�nek	barre
beton	beton
bez	bi, bedun
bez-	bi-
bezbarv�	birang
bezbolestn�	bidard
bezcenn�	bibah�, biqeymat, biarze�, n�ciz
bezd�tn�	bibacce
bezdr�tov�	bisim
bezejmenn�	bin�m, bine��n
bezmotorov�	bimotor
bezpe�n�	motmaen
bezpracn�	bizahmat
bezpr�v�	biq�nun
bezprost�edn�	mostaqim
bezv�znamn�	biarze�, bibah�
b�ec	davande
b�et	davidan
bicykl	docarxe
bi�	t�ziy�ne
biftek	biftek
bilance	tar�z
b�l� fazole	b�qel�
bilion	biliyon
b�l�	sefid
bl�hov�	n�d�n
bl�na	parde
bl�zen	div�ne
blecha	kak
blika�	cer�q e r�hnam�
bl�zko	nazdik
bl�zk�	b�rik
bli���	nazdiktar
blud	zandegi
bobr	bidastar
bobtnat	�m�s kardan
bobule	d�ne
bo�n�	pahluyi
bodl�k	x�r
bohat�r	pahlav�n
bohoslov�	xod�en�si
bohu�el	moteassef�ne
boj�cn�	tarsu
bojkot	tahrim
bojkotovat	tahrim kardan
bojovat	jang kardan
bojovn�	jangi
bok	pahlu
bolen� b�icha	�ekamdard
bolest	dard, ranj
bolestiv�	ranj�var, dard�var
bol�evick�	bol�eviki
bol�evik	bol�evik
bomba	bomb
borovice	k�j
bota	kaf�
botanika	giyah�en�si
boty	joft kaf�
bouda	k��ne
brada	c�ne
bradavice	zegil
brambor	sib zamini
bramb�rky	cips
br�t	bordan
bratr	bar�dar
bratranec	amuz�de, pesar-e-x�le, pesar-e-amme
br�zda	�iy�r
brid� (hra)	brij
broskev	�aft�lu, holu
brouk	susk
br�le	eynak
brynd��ek	pi�band e bace, pi�band e bacce
brzda	tormoz
brzy	zud
b�eh	s�hel
b�eh (mo�e)	ken�r e dary�
b�ezen	m�rs
b�icho	�ekam, me'de
b�itva	tix, tiq
bude	x�had bud
bude d�l�n	karde x�had �od
bude d�lat	x�had kard
bude hr�t	b�zi x�had kard
bude cht�t	x�had x�st
bude j�st	x�had xord
bude l�mat	x�had �ekast
bude m�t	x�had d�t
bude odpov�dat	jav�b x�had d�d
bude p�t	x�had ��mid
bude po��tat	x�had �omord
bude �ezat	x�had bord
bude ��kat	x�had goft
bude se pt�t	x�had porsid
bude se st�vat	x�had �od
bude sly�et	x�had �enid
bude sp�t	x�had x�bid
bude v�d�t	x�had d�nest
bude zav�rat	x�had bast
budeme	x�him bud
budeme d�l�ni	karde x�him �od
budeme d�lat	x�him kard
budeme hr�t	b�zi x�him kard
budeme cht�t	x�him x�st
budeme j�st	x�him xord
budeme l�mat	x�him �ekast
budeme m�t	x�him d�t
budeme odpov�dat	jav�b x�him d�d
budeme p�t	x�him ��mid
budeme po��tat	x�him �omord
budeme �ezat	x�him bord
budeme ��kat	x�him goft
budeme se pt�t	x�him porsid
budeme se st�vat	x�him �od
budeme sly�et	x�him �enid
budeme sp�t	x�him x�bid
budeme v�d�t	x�him d�nest
budeme zav�rat	x�him bast
bude�	x�hi bud
bude� d�l�n	karde x�hi �od
bude� d�lat	x�hi kard
bude� hr�t	b�zi x�hi kard
bude� cht�t	x�hi x�st
bude� j�st	x�hi xord
bude� l�mat	x�hi �ekast
bude� m�t	x�hi d�t
bude� odpov�dat	jav�b x�hi d�d
bude� p�t	x�hi ��mid
bude� po��tat	x�hi �omord
bude� �ezat	x�hi bord
bude� ��kat	x�hi goft
bude� se pt�t	x�hi porsid
bude� se st�vat	x�hi �od
bude� sly�et	x�hi �enid
bude� sp�t	x�hi x�bid
bude� v�d�t	x�hi d�nest
bude� zav�rat	x�hi bast
budete	x�hid bud
budete d�l�ni	karde x�hid �od
budete d�lat	x�hid kard
budete hr�t	b�zi x�hid kard
budete cht�t	x�hid x�st
budete j�st	x�hid xord
budete l�mat	x�hid �ekast
budete m�t	x�hid d�t
budete odpov�dat	jav�b x�hid d�d
budete p�t	x�hid ��mid
budete po��tat	x�hid �omord
budete �ezat	x�hid bord
budete ��kat	x�hid goft
budete se pt�t	x�hid porsid
budete se st�vat	x�hid �od
budete sly�et	x�hid �enid
budete sp�t	x�hid x�bid
budete v�d�t	x�hid d�nest
budete zav�rat	x�hid bast
bud�k	s�at zangdar
budka	b�je
budou	x�hand bud
budou d�l�ni	karde x�hand �od
budou d�lat	x�hand kard
budou hr�t	b�zi x�hand kard
budou cht�t	x�hand x�st
budou j�st	x�hand xord
budou l�mat	x�hand �ekast
budou m�t	x�hand d�t
budou odpov�dat	jav�b x�hand d�d
budou p�t	x�hand ��mid
budou po��tat	x�hand �omord
budou �ezat	x�hand bord
budou ��kat	x�hand goft
budou se pt�t	x�hand porsid
budou se st�vat	x�hand �od
budou sly�et	x�hand �enid
budou sp�t	x�hand x�bid
budou v�d�t	x�hand d�nest
budou zav�rat	x�hand bast
budovat	s�xtan
budu	x�ham bud
budu d�l�n	karde x�ham �od
budu d�lat	x�ham kard
budu hr�t	b�zi x�ham kard
budu cht�t	x�ham x�st
budu j�st	x�ham xord
budu l�mat	x�ham �ekast
budu m�t	x�ham d�t
budu odpov�dat	jav�b x�ham d�d
budu p�t	x�ham ��mid
budu po��tat	x�ham �omord, x�ham �omord
budu �ezat	x�ham bord
budu ��kat	x�ham goft
budu se pt�t	x�ham porsid
budu se st�vat	x�ham �od
budu sly�et	x�ham �enid
budu sp�t	x�ham x�bid
budu v�d�t	x�ham d�nest
budu zav�rat	x�ham bast
bufet	bufe
B�h	Xod�
b�h	parvardeg�r, yazd�n, izad
B�h t� prov�zej	Xod� negahd�r
buk	�le�, z�n
byl	bud
byl b�val	bude bud
byl d�l�n	karde �od
byl jsem	budam
byl jsem b�val	bude budam
byl jsem d�l�n	karde �odam
byl jsem sn�dl	xorde budam
byl jsem ud�lal	karde budam
byl jsem ud�l�n	karde �ode budam
byl jsi	budi
byl jsi b�val	bude budi
byl jsi d�l�n	karde �odi
byl jsi sn�dl	xorde budi
byl jsi ud�lal	karde budi
byl jsi ud�l�n	karde �ode budi
byl sn�dl	xorde bud
byl ud�lal	karde bud
byl ud�l�n	karde �ode bud
byli	budand
byli b�vali	bude budand
byli d�l�ni	karde �odand
byli jsme	budim
byli jsme b�vali	bude budim
byli jsme d�l�ni	karde �odim
byli jsme sn�dli	xorde budim
byli jsme ud�lali	karde budim
byli jsme ud�l�ni	karde �ode budim
byli jste	budid
byli jste b�vali	bude budid
byli jste d�l�ni	karde �odid
byli jste sn�dli	xorde budid
byli jste ud�lali	karde budid
byli jste ud�l�ni	karde �ode budid
byli sn�dli	xorde budand
byli ud�lali	karde budand
byli ud�l�ni	karde �ode budand
byt	�abest�n
b�t	budan
b�t schopen	tav�nestan
b�t vd��n�	majbur budan
b�v�	mib�ad
b�vaj�	mib�and
b�val	mibud
b�val jsem	mibudam
b�val jsi	mibudi
b�vali	mibudand
b�vali jsme	mibudim
b�vali jste	mibudid
b�v�m	mib�am
b�v�me	mib�im
b�v�	mib�i
b�v�te	mib�id
cedit	s�f kardan
cedn�k	s�fi
cedr	sedr
cedulka	barcasb
celer	karafs
celn�	gomroki
celnice	gomrok
celul�za	seluloz
cel�	tam�m
cement	sim�n
cena	bah�, qeymat
centrum	miy�ne
cesta	r�h
cestov�n�	mos�ferati
cestovat	mos�ferat kardan
cestovatel	mos�fer
cestovn� kancel��	��ns e mos�ferati, bong�h e mos�ferati
cestovn� pas	gozarn�me
cestuj�c�	mos�fer
cibule	piy�z
cigareta	sig�r
cihla	�jor
cik�n	kuli
cik�nsk�	kuli
c�lev�dom�	b�'er�de
c�n	sorb, qal'
c�p	gu�e
c�rkev	mezhab, ruh�niyat
c�rkevn�	mezhabi
c�sa�	��h, p�d��h
cit	hes
citron	limu
citronov�	limuyi
cizolo�stv�	bivaf�yi, zen�, bituze�i
co	ci, ce
cokoliv	har ciz, har k�r
con�nke	jak, jako
cuketa	kadu
cukr	�ekkar
cukr�rna	�iriniforu�i
cukyn�	kadu
cupanina	kat�n
cyp�i�	sarv
� (hl�ska)	c (horuf)
�aj	c�y
�ajovna	qahvex�ne
�alam�da	tor�i
��ra	xatt
�as	vaqt, asr, zam�n
�asopis	majalle
�asov�	zam�ni
�asto	b�rh�
�ast�	b�rh�
�asy	owq�t
�ek�rna	ot�q e entez�r, s�lon e entez�r
�ekat (na)	sabr kardan
�elist	fak
�eln�	az sar, sarbesar
�elo	pi��ni
�enich	puze
�enichat	pu kardan
�epec	kol�h
�epelka (holic�)	xodtar�
�epice	kol�h
�er�	me�ki
�ern�	siy�h, me�ki
�ern� ka�el	siy�hsorfe
�erpadlo	pomp
�erstv�	t�ze
�ert	ahriman
�erven	�uan, �uan
�erven�	qermez
�erven� zel�	kalam e qermez
�ervenec	�uye, �uye
�esan� p��ze	nax e pa�m, pa�mi
�esk� republika	Jomhuri ye Ceki
�esk�	ceki
�esnek	sir
��ka	ka�kak
�eta�	goruhb�n
��	az �n e ke
�init	kardan
��slo	�om�re, adad
��slo domu	�om�re ye x�ne
��st	x�ndan
�ist�rna	xo�k�uyi
�istotn�	p�kize
�len	and�m
�lov�k	�d�m, fard, ens�n
�lun	q�yeq
�o�ka	adas
�okol�da	�okl�t, �okol�t
�okol�dov�	�okl�ti
�trn�ct	cah�rdah
�tverec	cah�rgu�
�tvrt	robh
�tvrtek	panj�anbe
�tvrtina	cah�rom, c�rak
�tvrt�	cah�rom
�ty�i	cah�r
�ty�i sta	cah�rsad
�ty�icet	cehel
d�	x�had d�d
��bel	ahriman, div
daj�	x�hand d�d
dal	d�d
dal jsem	d�dam
dal jsi	d�di
daleko	dur, ken�r
dalek�	dur
dali	d�dand
dali jsme	d�dim
dali jste	d�did
d�m	x�ham d�d
d�ma	b�nu
d�me	x�him d�d
d�msk� vlo�ka	dastm�l e behd�ti
d�my	b�nuv�n
D�nsko	D�nm�rk
d�	x�hi d�d
d�t	d�dan, bax�idan
d�te	x�hid d�d
datle	xorm�
d�v�	midehad
d�vaj�	midehand
d�val	mid�d
d�val jsem	mid�dam
d�val jsi	mid�di
d�vali	mid�dand
d�vali jsme	mid�dim
d�vali jste	mid�did
d�v�m	mideham
d�v�me	midehim
d�v�	midehi
d�vat	d�dan
d�v�te	midehid
dcera	doxtar
dcera str�ce z mat�iny strany	doxtar-e-d�yi
dcera str�ce z otcovy strany	doxtar-e-ammu
dcera tety z mat�iny strany	doxtar-e-x�le
dcera tety z otcovy strany	doxtar-e-amme
debata	bahs
debatovat	bahs kardan
d�de�ek	pedarbozorg
d�dictv�	abarm�nd
d�jepis	t�rix
d�jiny	t�rix
d�kovat	ta�akor kardan, sepas goz�rdan, te�aker kardan
d�kuji	mota�akkeram, mote�akeram, sep�s goz�ram
d�l�	mikonad
d�laj�	mikonand
d�lal	kard
d�lal jsem	kardam
d�lal jsi	kardi
d�lali	kardand
d�lali jsme	kardim
d�lali jste	kardid
d�l�m	mikonam
d�l�me	mikonim
d�lan�	karde
d�l�	mikoni
d�lat	kardan
d�l�te	mikonid
d�l�val	mikard
d�l�val jsem	mikardam
d�l�val jsi	mikardi
d�l�vali	mikardand
d�l�vali jsme	mikardim
d�l�vali jste	mikardid
d�lej	kon
d�lka	der�zi
d�mon	jen, div
demonstrace	nem�ye�
den	ruz
den pracovn�ho klidu	ruz e tatil
denn�	ruz�ne
denominace	mezhab
denomina�n�	mezhabi
dentista	dand�npeze�k
deodorant	zedd e bu
deprese	afsordegi
deset	dah
desetilet�	dahs�le
desetina	dahom
d隝	b�r�n
d�tsk�	bacceg�ne
devades�t	navad
devaten�ct	nuzdah
d�v�e	doxtarce
dev�t	noh
dev�t set	nohsad
dev�tina	nohom
dezert	deser
dezodorant	zedd e bu
dialog	goftogu
dieta	parhiz
d�k	sep�s
diskutovat	bahs kardan
diskuze	bahs, goftogu
d�t�	bacce, kudak
d�tko	bacce
divadlo	te�tr
d�vka	du�ize, doxtar
divok� vep�	gor�z
dlouho	moddat
dlouh�	der�z
dluh	qarz
dnes	emruz
dnes ve�er	em�ab
dno	te, kaf
do	be, suye, besuye
doba	zam�n
dobro	xubi, xub
dobro�e�it	ya�tan
dobrota	xubi
dobrou noc	�ab be xeyr
dobr�	beh, xub
dodr�ovat	neg�h d�tan
dohromady	b�ham
dojit	du�idan
dolar	dol�r
dole	p�yine, p�yin, zire
dol�	p�yine, zire, p�eyn
domov	�vare�
dopis	n�me
dopisn� pap�r	k�qaz e y�dd�t
doporu�it	pi�nah�d kardan
dop�edu	bejelow
dost	bas, k�fi
dostat	gereftan
dostate�n�	k�fi, far�v�n
dostatek	far�v�ni, far�v�n, besy�r
dost�v�	migirad
dost�vaj�	migirand
dost�v�m	migiram
dost�v�me	migirim
dost�v�	migiri
dost�vat	gereftan
dost�v�te	migirid
dozr�vat	rasidan
drahokam	zivar
drah�	aziz, ger�n
drak	b�db�d�k
drama	dr�m
dr�t	sim
dr�t�n�	turi
dra���	ger�ntar
drn	caman
dr��ky	sir�bi
dr�bky	del o jegar e q�z
druh� t��da (ve vlaku)	daraje ye do
druh�	dovom
dru�ice	m�hv�re
dr�et	neg�h d�tan
d�ina	zahmat
d��ve	zudtar
duben	�vril, �vril
duch	j�n, rav�n, ruh, faravahr
d�l	k�n
d�m	x�ne, sar�y, kad
du�e	j�n, rav�n
du�en� maso se zeleninou	xore�
d�v�ra	b�var
dva	do
dva tis�ce	do hez�r
dvacet	bist
dvakr�t	do b�r
dvan�ct	dav�zdah
dv� st�	devist
dve�e	dar, d�r
dvoul��kov� kup�	kupe ye dotaxti
d�m	dud
dynamo	din�m
d�n�	kadu ye mosamm�yi
d� (hl�ska)	j (horuf)
d�b�n	kuze
d�ez	j�z
d�in	jen
d��ny	�alv�r e jin
elegantn�	zib�
elektrick� hodiny	s�at e elektriki
elektrick� holic� strojek	xodtar� e barqi
eso	takx�l, �s
e�teh�	chu�
etiketa	barcasb
Evropa	Orup�
evropsk�	orup�yi
existence	zist
existuje	mib�ad
existujeme	mib�im
existuje�	mib�i
existujete	mib�id
existuji	mib�am
existuj�	mib�and
expanze	afz�ye�
ext�ze	azxodbixod�odegi
famili�rn�	�n�
fa�ismus	f�ism
fa�ista	f�ist
fa�istick�	f�isti
federace	feder�siyon
federativn�	feder�l
f�n	muxo�kkon
fialov�	banaf�
f�k	anjir
film	film
filtr	filter
filtr (cigar.)	filterd�r
flanel	p�rce ye pa�mi (sad dar sad)
folk	musiqi ye mardomi
folkov� hudba	musiqi ye mardomi
fond�n	sarehambandi
fotbal	futb�l
fotoapar�t	durbin e akk�si
francouzsk�	far�nsavi
frank	fr�nk
galaxie	kahka��n
galerie	sarsar�, neg�rest�n
gar�	g�r�
garn�t	meygu
g�za	g�z e p�nsom�n
geografie	joqr�fiy�
gesto	e��re
golf	golf
graf�m	harf
gram	gram
gramatika	dastur e zab�n
gramofon	gr�m
gran�tov� jablko	an�r
grapefruit	p�mplimus
grep	p�mplimus
guma	med�d p�kkon, med�dp�kkon, l�stik
gumov�	lastiki
had	m�r
h�danka	cist�n
had�i	haji
halasn�	boland
hamburger [hamburgr]	hamberger
hedv�b�	abri�om, �bri�om
hegemonie	bartari
hektick�	bi�ram
helikopt�ra	helikopter
hemoroidy	bav�sir
hereze	zandegi
hezk�	qa�ang, zib�
historie	t�rix
hladov�	gorosne
hl�sat	pand d�dan
hlasit�	boland
hl�ska	horuf
hlava	sar
hl�vkov� sal�t	k�hu
hledat	jostoju kardan
hloubka	�arf�
hlubok�	�arf, gud
hluch�	kar
hned	fori
hn�d�	qahve i
ho	ur�
hodina	vaqt, s�at
hodin��stv�	s�ats�zi
hodinky	s�at
hodiny	s�at e div�ri
hodn�	xeyli, ziy�d
hodnota	arze�, bah�
hoch	pesar
holic� strojek (elektr.)	ri�tar�
holi�stv�	�r�ye�g�h
holit	tar�idan
holit se	ri� tar�idan
holub	kabutar
hora	kuh
hore�ka	tab
hork� �okol�da	�ir k�k�o
hork�	�ta�in, garm
horliv�	b�qeyrat
hor��	badtar
ho��ice	xardal
ho�k�	talx
Hospodin	Xod�vand
host	mehm�n
hostinec	mehm�nx�ne, mos�ferx�ne
hot dog	h�td�g
hotel	hotel
hotelov� z��zenec	p�dow, ��gerd
houba	espanj, q�rc
houf	dam
hov�z� (maso)	gu�t e g�v
hovo�it	harf zadan
hra	nam�ye�n�me, b�zi
hra (drama)	nam�ye�
hrac� karta	varaq e b�zi
hra�k��stv�	asb�b e b�ziforu�i
hr�ch	naxod
hr�ch (zelen�)	noxod e sabz
hraje	b�zi mikonad
hrajeme	b�zi mikonim
hraje�	b�zi mikoni
hrajete	b�zi mikonid
hraji	b�zi mikonam
hraj�	b�zi mikonand
hr�l	b�zi kard
hr�l jsem	b�zi kardam
hr�l jsi	b�zi kardi
hr�li	b�zi kardand
hr�li jsme	b�zi kardim
hr�li jste	b�zi kardid
hranice	marz
hr�t	b�zi kardan
hr�val	b�zi mikard
hr�val jsem	b�zi mikardam
hr�val jsi	b�zi mikardi
hr�vali	b�zi mikardand
hr�vali jsme	b�zi mikardim
hr�vali jste	b�zi mikardid
hrdina	del�var
hrdlo	galu
hrnek	fenj�n
hrob	gur
hrobka	gur
hrozen	angur
hrtan	galu
hru�	sine, pest�n
hrudn�k	sine
hru�ka	gol�bi, amrud
h�bet	sotun e faqar�t
h�bitov	�r�mg�h, gurest�n
h�eben	��ne, �ane
h�ib	g�rc, q�rc
h��ch	gon�h, bezeh, �st�r
h��n�k	gon�hk�r, bezehk�r
h��va	y�l
hudba	musiqi, xoniy�
husa	q�z
hustilka	tolombe
hv�zda	set�re
hv�zd��	set�re�en�s
hymna	sorud
ch (hl�ska)	x (horuf)
charakter	nah�d
chata	kolbe, kalbe
chce	mix�had
chceme	mix�him
chce�	mix�hi
chcete	mix�hid
chci	mix�ham
chladic� syst�m	hav�ka�
chladi�	r�diy�tor, radi�tor
chladn�	sard
chlapec	pesar
chlazen�	hav�ka�
chl�b	n�n
chleb��ek	gerd e n�n e kucek
chl�v	k�vd�ni
chl�r	klor
chlup	pa�m
chmel	r�zak
cho�	r�h boro
chodit	r�h raftan
chodn�k	piy�de row, piy�derow
chov�n�	raft�r
chrabrost	arvandi
chrom	krom
chronick�	mozmen
chronologie	�arh e t�rixi, t�rix�om�ri
ch�est	m�rcube
ch�ipka	�nflu�nz�
cht�j�	mix�hand
cht�l	x�st
cht�l jsem	x�stam
cht�l jsi	x�sti
cht�li	x�stand
cht�li jsme	x�stim
cht�li jste	x�stid
cht�t	x�stan
chu�	e�teh�
chutn�	laziz
chv�la	set�ye�
chv�lit	set�ye� kardan
chyba	e�teb�h, �rang
chybovat	e�teb�h namudan
chystat	�m�de �odan
chytat	gereftan
chytit	gereftan
i	niz, ham, va, o
ide�ln�	�rm�n, ide�l
Indie	Hend, Hendust�n
infekce	cerkkardegi
informace	�g�hi
inkoust	jowhar
in�en�r	mohandes
ion	yon
Ir�k	Ar�q
�r�n	Ir�n
�r�nsk� isl�msk� republika	Jomhuri ye Eslami ye Ir�n
�r�nsk�	ir�ni
isl�m	isl�m, esl�m
isl�msk�	isl�mi, esl�mi
Island	Island
islandsk�	Islandi
It�lie	It�liy�
izolace	�yeq-s�zi
Izrael	Esr�il
j (hl�ska)	y (horuf)
j�	man
jablko	sib
jadern�	hasteyi, atomi
j�dro	haste
jahoda	tut e farangi
jak	cetor, cegune, cetowr
jak mnoho	cand
jako	con�nke, mesl, m�nande, con
jak�	ce, cetowr, ci, cand, kod�m
j�ma	cah
jantar	kahrob�
jaro	bah�r
j�tra	jegar
jazyk	barge, zab�n
jazz [d�ez]	j�z
jde	miravad
jdeme	miravim
jde�	miravi
jdete	miravid
jdi	boro
jdou	miravand
jdu	miravam
je (akuzativ z�jmena)	�nh�r�
je d�l�n	karde mi�avad
je d�l�v�n	karde mi�od
je ud�l�n	karde �ode'ast
je(st)	hast
jed	sam, zahr
jeden	yek
jeden�ct	y�zdah
jedenkr�t	yek b�r
jed�	mix�rand
jedl	xord
jedl jsem	xordam
jedl jsi	xordi
jedli	xordand
jedli jsme	xordim
jedli jste	xordid
jednoduch�	s�de
jednoho dne	yekruz
jednol��kov� kup�	kupe ye yektaxti
jednostrann�	yekpahlu
jednotliv�	nafar
jednou	yekruz, yek b�r
Jedu do Teher�nu.	Man be Tehr�n miravam.
jehla	suzan
jehlice do kravaty	suzan e ker�v�t
jehn�	barre
jeho	e u, -a�
jej	ur�
jejich	e i��n, -e�an
jelen	gavazn
jemn�	zarif
jemu	beu
jen	tanh�, yeg�ne
jenom	yeg�ne, tanh�
jest	ast
jestli	agar
je�t�	hanuz
jet	r�ndan
jevit se	nemudan, namudan
jez (j�st)	boxor
jezero	dary�ce
jez�rko	berke
Je��	Eysa, Eys�, Is�
Je�� Kristus	Is� Masih
jho	yuq
j�	mix�rad
j�deln� v�z	v�gon e qaz�xori
j�dlo	qaz�
jih	jonub
jikry	toxm e m�hi
jim	be �nh�
j�m	mix�ram
jim (pro osoby)	be i��n
j�me	mix�rim
jin� (dal��)	digar
j�st	xordan
jist�)	-i
jist�) po samohl�sce	-yi
j�	mix�ri
j�t	raftan
j�te	mix�rid
j�zdenka	belit
j�zdn� kolo	docarxe
j�zdn� ��d	ket�b e r�hnam� ye r�h-�han
jm�no	n�m, esm
jmenovat	gom�rdan
j�d	yod
jsem	hastam, am
jsem d�l�n	karde mi�avam
jsem d�l�v�n	karde mi�odam
jsem ud�l�n	karde �ode'am
jsi	hasti, i
jsi d�l�n	karde mi�avi
jsi d�l�v�n	karde mi�odi
jsi ud�l�n	karde �ode'i
jsme	hastim, im
jsme d�l�ni	karde mi�avim
jsme d�l�v�ni	karde mi�odim
jsme ud�l�ni	karde �ode'im
jsou	hastand, and
jsou d�l�ni	karde mi�avand
jsou d�l�v�ni	karde mi�odand
jsou ud�l�ni	karde �ode'and
jste	id, hastid
jste d�l�ni	karde mi�avid
jste d�l�v�ni	karde mi�odid
jste ud�l�ni	karde �ode'id
k	besuye, suye, be
kab�t	p�lto
kabel	k�bl
kade�nictv�	�r�ye�g�h e zan�ne
kachna	ordak
kalam��	dav�t
kalamita	bal�, badbaxti
kalend��	s�ln�me, g�hnam�
kalhoty	�alv�r, �alvar
kalkulovat	hes�b kardan
kamar�d	dust
kambala velk�	m�hi ye sim
kamenovat	sangs�r kardan
kamion	k�miyon
kampa�	mob�reze, la�karka�i
Kanada	Kanada
kan�l	k�n�l
kanystr	pit
kapacita	gonj�ye�
kapesn� hodinky	s�at e jibi
kapesn�k	dastm�l
kapky do o��	qatre ye ce�m
kapky do u��	qatre ye gu�
kapsa	jib
k�ra	g�ri
karafa	tong
karamel	k�r�mel
kar�t	qir�t
karavan	k�rev�n
karban�tek	kufte ye rize
karbonov� pap�r	meqd�r k�rbon
karbur�tor	karbur�tor
kard	x�him
kardin�l	k�rdin�l
karotka	zardak
kart��	bros
kart��ek na nehty	bros e n�xon
kart��ek na zuby	dand�n�uy
karton	k�rton
ka�tan	��hbalut
katalog	ket�b e fehrest
katedra	miz
k�va	qahve
kav�rna	qahvex�ne
kavi�r	x�viy�r
k�vovar	s�fi
k�zat	pand d�dan
kazeta	k�set
ka�d�	har
ka�d� den	har ruz
kde	koj�
kdekoliv	har koj�, har j�
kdo	ki
kdy	key
kdy�	vaqti
kedluben	�alqam
kedlubna	�alqam
kempink	ordug�h, kemping
keramick�	ser�miki
keramika	ser�mik
ke�	bute
k� bych	omid�ram ke
kilo	kilo
kilogram	kilo
kilometr	kilumetr, kilometr
kino	sinem�, sinema
klakson	buq
kl�vesnice	kibord
klenot	zivar
klenotnice	gowhard�n
klepat (na dve�e)	dar zadan
kl��	kelid
kl��n� kost	ostox�n e tarqove
klid	�r�me�, �sudegi
klidn�	�r�m
klientela	gomrok
klikov� h��del	milelang
klob�sa	sosis
klobouk	kol�h
kloub	mafsal
kluk (karty)	sarb�z
kniha	ket�b
knihkupectv�	ket�bforu�i
knihovna	ket�bx�ne
knihy	kotob
kn�r	sebil
knofl�k	dokme
koberec	q�li, far�
ko�ka	gorbe
kohout	xorus
kokos	n�rgil
kol��	koluce, keyk
kolem	atr�f, gerd�gerd, pir�mun
koleno	z�nu
kolik	cand, ceqadr
kolo	carx
kom�r	pa�e
kombin�za	b�l�pu�
komedie	komedi
komorn�k	pi�xedmat
konat	kardan
konat pr�ci	k�r kardan
kondice	h�l
konec	�xar, p�y�n
konvice	quri
konzerva	quti
konzul�t	konsulgari
kopan�	futb�l
kopec	tappe
kop�iva	gazane
kor�l	marj�n
kor�n	qor�n
Korea	Kore
kormidlo	nok
koroptev	kabk
koruna	t�j
kos	z�qi
kosa	d�s
kosmetick� salon	s�lon e zib�yi
kost	ostox�n
kostel	kelis�
kostka cukru	qand
kost�m	j�me
ko�	sabad
ko�ile	pir�han
ko�t�	j�rub
kotleta	kotlet
kotl�k	dig
kotn�k	moce p�
koupac� �epice	kol�h e �osto�u
koupac� pl᚝	howle ye hamm�m
koupelna	hamm�m
koupit	xaridan
kou�en� zak�z�no	estem�l e dox�niy�t mamnu ast
kousat	gazidan
kouzlo	j�du
ko�en�	carmi
ko�ich	kot e xaz
krabice	qoti, ja'be
krachl�	var�ekaste
krajka	p�rce ye turi
kr�l	solt�n, p�d��h, ��h
Kr�l kr�l�	��h e ��h�n
kr�l kr�l�	��h�n��h
kr�l�k	xargu�
kr�lovna	�ahrb�nu, �ahb�nu
kr�lovsky	��hv�r
kr�lovsk�	��h�n��hi
kr�lovstv�	p�d��hi
kr�sa	zib�yi, xo�geli
kr�ska	xo�gel
kr�sn�	zib�, qa�ang
kr�tk�	kut�h
kratochv�le	sargami
krat��	kut�htar
kr�va	g�v
kravata	kr�v�t, dastm�l e gardan
kreditn� karta	k�rt e e'teb�r
krej��	darzi
kr�m	kerem
kr�m na opalov�n�	kerem e �ft�b
kr�m na ruce	kerem e dast
kreslic� pap�r	k�qaz e naqq�i
kreslit	�hixtan
krev	xun
krk	gardan
krocan	pilmorq, buqalamun
krok	g�m
krupice	balqur
kr�ta	buqalamun, pilmorq
k�e�	enqeb�z e m�hice, ta�annoj
k�epelka	beldercin
k�es�an	masihi
k��dlo	b�l
k��	salib
k�i�ovatka	cah�rr�h
kter�	ce, ci, kod�m
kufr	j�med�n
kuku�ice	zorrat
kulat�	gerd
k��	asb
kup�	kupe
kup�edu	bejelow
Kurdist�n	Kordest�n
ku�e	morq
ku�e(c�)	juje
k��e	pust, carm
kv�t	gol
kv�t�k	gol-kalam, gol e kalam
kv�ten	me
kv�tin��stv�	golforu�i
k�la	b�d e fatq
kysel�	tor�
labut�nka	gard e pof
lacin�	arz�n
l�hev	botri
lak	l�kalkol
lak na nehty	l�k e n�xon
lak na vlasy	t�ft, gisuaf��n
l�mal	�ekast
l�mal jsem	�ekastam
l�mal jsi	�ekasti
l�mali	�ekastand
l�mali jsme	�ekastim
l�mali jste	�ekastid
l�mat	�ekastan
l�me	mi�ekandad
l�meme	mi�ekandim
l�me�	mi�ekandi
l�mete	mi�ekandid
l�mou	mi�ekandand
lampa	cer�q, l�mp
l�mu	mi�ekandam
la�	�hu
lan��	dombal�n
l�ska	e�q, mehr
laskavost	xubi
laskav�	mehrb�n
latinka	xatt e l�tin
latinsk�	l�tin
l�tka	p�rce
lavice	miz, nimkat
lavor	lagan
l�ze�	hamm�m
l��ivo	d�ru
l��ka	d�m
led	yax
leden	��nvie, ��nvie
ledvina	qolve, kolye
ledvinka	qolve
leh�tko	sandali ye �s�ye�
lehk�	s�de, sabok
l�k	d�ru
l�k�rna	d�rux�ne
l�k�rni�ka	ja'be ye komakh� ye naxostin
l�ka�	peze�k
l�ka�sk� p�edpis	nosxe
l�ka�stv�	peze�ki
lepidlo	casb
lepit	casb�ndan
lep��	behtar
les	jangal, bi�e
lesn�	jangali
letadlo	hav�peym�
leti�t�	forudg�h
l�to	t�best�n
leukoplast	casb e zaxm
lev	�ir
levn�j��	arz�ntar
levn�	arz�n
lev�	cap
libra	pond
l�ce	gune
lid�	basteg�n
lidsk� rod	ne��d e ens�n
lilek (jedl�)	b�denj�n
l�mec	yaqe
limon�da	limun�d
linka	xatt
l�skov� o��ek	fandoq
list	barg, varaq
l�stek	belit
listopad	nov�mbr
l�tost	t�ssof
litr	litr
ln�n� tkanina	panbeyi, p�rce ye kat�ni
lo�	zoraq, ka�ti
loket	�ranj
loni	p�rs�l
losos	m�hi ye �z�d
louka	camanz�r
loutna	ud
lo�nice	ot�q e x�b, x�bg�h
l��ko	bastar, raxtex�b
lys�	kacal
l��ce	q�oq
m�	d�rad
magnetofon (kazet.)	zabt e sowt
majetek	m�l
maj�	d�rand
makrela	m�hi ye x�ld�r
malina	teme�k
m�lo	kam
malovat	�hixtan
mal�	xorde, kucak, kucek
m�m	d�ram
m�ma	m�m�
m�me	d�rim
mandarinka	n�rangi
mandle	b�d�m
mandle (anat.)	lowze, b�d�mak
man�vrovat	neyrang zadan
mango	anbe
maniak	�ta�i
manik�ra	m�nikur
man�estr	maxmal
man�el	�owhar
man�elka	hamsar
man�eta	dokme ye sardast
mapa	naq�e
mapa velk�ho m���tka	naq�e b� meqy�s e bozorg
Marie	Maryam
marka	m�rk
marmel�da	morabb�
m�slo	kare
masna	gu�tforu�i
maso	gu�t
mastn�	carb
m�	d�ri
mat	m�t
m�te	d�rid
materi�l	p�rce
matice	mohre
matka	m�dar
matka (u �roubu)	mohre
matrace	to�ak
m�	manr�
me�	�am�ir
med	asal
m��	mes
medv�d	xers
m�j r�d	dust bed�r
m�l	d�t
m�l jsem	d�tam
m�l jsi	d�ti
m�li	d�tand
m�li jsme	d�tim
m�li jste	d�tid
meloun	hendav�ne
membr�na	parde
m�n�	kamtar
m�ni�	tr�nsform�tor
men��	kucaktar, xordtar
meru�ka	zard�lu
m���tko	meqy�s
m�s�c	m�h
m�sto	�ahrak, �ahr
m�stsk� policie	�ahrb�ni
me�ita	masjed
metr	metr, meter
metro	metro
mezi	darmiy�ne, andar, beyn
mi	beman
m��	tup
mikina	bluz
mikrobus	minibus
milenec	dustd�r, �eq
miliarda	miliy�rd, mili�rd
milion	miliyon, milion
milosrdenstv�	bax�e�, bax��yandegi, delsuzi
milost	sangini, vaq�r
milostn�	kere�me
milovat	e�q budan
mil�	xo�, aziz
mince	sekke
ministryn�	vazir
minist�i	vozar�
minuta	daqiqe
m�r	�s�ni, �r�me�, �ti
miska	k�se
m�stnost	ot�q
m�sto	j�
m�sto	j�
m�stodr�itelstv�	vel�yat
m�t	d�tan
m�t platnost	eteb�r d�tan
m�t r�d	dust d�tan
m�t sen	x�b didan
m�val	mid�t
m�val jsem	mid�tam
m�val jsi	mid�ti
m�vali	mid�tand
m�vali jsme	mid�tim
m�vali jste	mid�tid
mix�r	hamzan
mlad�	jav�n
ml�ko	�ir
mlhav�	meh�lud
mluv	harf bezan
mluvit	harf zadan
mluvnice	dastur e zab�n
ml�n	�sy�b
mne	manr�
mn�	beman
mnoho	ziy�d, xeyli
moc	am�vandi, qodrat
moci	tav�nestan
mo�	ure
modlit se	niy�ye� kardan, nam�z kardan
modlitba	niy�ye�, nam�z
modr�	�bi
mod�	kabud
Mohamed	Mohammad
mokro	xis
mol	bid
Morava	Mor�viy�
moru�e	tut
mo�e	dary�
most	pol
motocykl	motorsiklet
motorov� �lun	q�yeq e motori
motorov� olej	rowqan e motor
mot�l	parv�ne
mou�n�k	keyk
mouka	�rd
mozek	maqz
mo�n�	��yad
mo�no	momken
mo�n�	momken
mrak	abr
mrdat	g�yidan
mrkev	havij
m�j	-am, e man
mul	g�z e p�nsom�n
muset	b�yad, b�yast
muslim	mosalm�n
muzeum	muze
mu�	mard
mu�n�	mard�ne
my	m�
m�dlo	s�bun
m�lit se	e�teb�h namudan
myslet	fekr kardan, andi�idan
my�lenka	andi�e
na	bar
na prodej	bar�ye foru�
na shledanou	Xod� negahd�r, be omid e did�r
na vid�nou	be omid e did�r
n�bo�ensk� obec	mezhab
n�bo�enstv�	din
nacista	n�zi
n��rtn�k	k�qaz e pi�nevis
nad	b�l�ye, bartar, zabar, ruye
nad�je	omid
N�der	N�der
n�dhern�	zib�
n�dob�	zarf
n�dra��	istg�h
nahoru	b�l�
n�hradn� d�ly	qesmath� ye yadaki
nach�zet	peyd� kardan
nachlazen�	sarm�xordegi
najdi	peyd� kon
najmout	ej�re kardan
n�kaza	cerkkardegi
nakl�dan�)	xiy�r e �ur
n�kladn�	ger�n
n�klonnost	ger�megi
n�kup	xarid
nal�zat	peyd� kardan
n�m	bem�
n�m�st�	meyd�n
n�mo�n�	dary�yi
nap�jel jsem se	mi��midam
nap�jel jsi se	mi��midi
nap�jel se	mi��mid
nap�jeli jsme se	mi��midim
nap�jeli jste se	mi��midid
nap�jeli se	mi��midand
nap�t�	volt�
napij se	benu�
nap�t se	nu�idan
n�plast	casb e zaxm
n�poj	nu��ne
naproti	ruberuye, v�
nap���	sart�sar
n�ramkov� hodinky	s�at e moci
n�rod	p�darm, mellat
n�rodn�	melli, p�darmi
n�rodn� osvobozen�	nej�t e melli
narozen�	z�ye�
narozeniny	tavvalod
n��ad�	abz�r
na��zen�	�yinn�me
n�s	m�r�
n�straha	d�m
n�stroj	afz�r
n�stupi�t�	saku
n�	-eman, e m�
nat��ka	bigudi
n�t�ln�k	�ile
nauky	olum
n�u�nice	gu�v�re
navrhnout	pi�nah�d kardan
nav�dy	bar�ye hami�e, peyvaste, j�vid�n
nazdar	dorud
n�zev	n�m
ne	nah, xeyr, na
ne-	ne-, na-
nebe	�sm�n, behe�t, minu
nebesk�	�sm�ni
nebezpe��	se�, xatar
nebezpe�� smrti	xatar e marg
nebezpe�n�	xatarn�k
neblah�	badbaxt
nebo	y�
nebo�	conke, zir�
nebude	nax�had bud
nebude d�l�n	karde nax�had �od
nebude d�lat	nax�had kard
nebude hr�t	b�zi nax�had kard
nebude cht�t	nax�had x�st
nebude j�st	nax�had xord
nebude p�t	nax�had ��mid
nebude po��tat	nax�had �omord
nebude sp�t	nax�ham x�bid
nebude v�d�t	nax�had d�nest
nebude zav�rat	nax�had bast
nebudeme	nax�him bud
nebudeme d�l�ni	karde nax�him �od
nebudeme d�lat	nax�him kard
nebudeme hr�t	b�zi nax�him kard
nebudeme cht�t	nax�him x�st
nebudeme j�st	nax�him xord
nebudeme p�t	nax�him ��mid
nebudeme po��tat	nax�him �omord
nebudeme sp�t	nax�him x�bid
nebudeme v�d�t	nax�him d�nest
nebudeme zav�rat	nax�him bast
nebude�	nax�hi bud
nebude� d�l�n	karde nax�hi �od
nebude� d�lat	nax�hi kard
nebude� hr�t	b�zi nax�hi kard
nebude� cht�t	nax�hi x�st
nebude� j�st	nax�hi xord
nebude� p�t	nax�hi ��mid
nebude� po��tat	nax�hi �omord
nebude� sp�t	nax�hi xabid
nebude� v�d�t	nax�hi d�nest
nebude� zav�rat	nax�hi bast
nebudete	nax�hid bud
nebudete d�l�ni	karde nax�hid �od
nebudete d�lat	nax�hid kard
nebudete hr�t	b�zi nax�hid kard
nebudete cht�t	nax�hid x�st
nebudete j�st	nax�hid xord
nebudete p�t	nax�hid ��mid
nebudete po��tat	nax�hid �omord
nebudete sp�t	nax�hid x�bid
nebudete v�d�t	nax�hid d�nest
nebudete zav�rat	nax�hid bast
nebudou	nax�hand bud
nebudou d�l�ni	karde nax�hand �od
nebudou d�lat	nax�hand kard
nebudou hr�t	b�zi nax�hand kard
nebudou cht�t	nax�hand x�st
nebudou j�st	nax�hand xord
nebudou p�t	nax�hand ��mid
nebudou po��tat	nax�hand �omord
nebudou sp�t	nax�hand x�bid
nebudou v�d�t	nax�hand d�nest
nebudou zav�rat	nax�hand bast
nebudu	nax�ham bud
nebudu d�l�n	karde nax�ham �od
nebudu d�lat	nax�ham kard
nebudu hr�t	b�zi nax�ham kard
nebudu cht�t	nax�ham x�st
nebudu j�st	nax�ham xord
nebudu p�t	nax�ham ��mid
nebudu po��tat	nax�ham �omord
nebudu sp�t	nax�ham xabid
nebudu v�d�t	nax�ham d�nest
nebudu zav�rat	nax�ham bast
nebyl	nabud
nebyl d�l�n	karde na�od
nebyl jsem	nabudam
nebyl jsem d�l�n	karde na�odam
nebyl jsem ud�lal	nakarde budam
nebyl jsem ud�l�n	karde �ode nabudam
nebyl jsi	nabudi
nebyl jsi d�l�n	karde na�odi
nebyl jsi ud�lal	nakarde budi
nebyl jsi ud�l�n	karde �ode nabudi
nebyl ud�lal	nakarde bud
nebyl ud�l�n	karde �ode nabud
nebyli	nabudand
nebyli d�l�ni	karde na�odand
nebyli jsme	nabudim
nebyli jsme d�l�ni	karde na�odim
nebyli jsme ud�lali	nakarde budim
nebyli jsme ud�l�ni	karde �ode nabudim
nebyli jste	nabudid
nebyli jste d�l�ni	karde na�odid
nebyli jste ud�lali	nakarde budid
nebyli jste ud�l�ni	karde �ode nabudid
nebyli ud�lali	nakarde budand
nebyli ud�l�ni	karde �ode nabudand
neb�val	namibud
neb�val jsem	namibudam
neb�val jsi	namibudi
neb�vali	namibudand
neb�vali jsme	namibudim
neb�vali jste	namibudid
neces�r	ja'be ye abz�rh� ye �r�ye�
n�co	yek cizi, cizi
ne�istotn�	cerk, n�p�k
ne�ist�	cerk
ned�	nax�had d�d
nedaj�	nax�hand d�d
nedal	nad�d
nedal jsem	nad�dam
nedal jsi	nad�di
nedali	nad�dand
nedali jsme	nad�dim
nedali jste	nad�did
ned�m	nax�ham d�d
ned�me	nax�him d�d
ned�	nax�hi d�d
ned�te	nax�hid d�d
ned�v�	namidehad
ned�vaj�	namidehand
ned�val	namid�d
ned�val jsem	namid�dam
ned�val jsi	namid�di
ned�vali	namid�dand
ned�vali jsme	namid�dim
ned�vali jste	namid�did
ned�v�m	namideham
ned�v�me	namidehim
ned�v�	namidehi
ned�v�te	namidehid
nedbale	behar h�l
ned�l�	namikonad
ned�laj�	namikonand
ned�lal	nakard
ned�lal jsem	nakardam
ned�lal jsi	nakardi
ned�lali	nakardand
ned�lali jsme	nakardim
ned�lali jste	nakardid
ned�l�m	namikonam
ned�l�me	namikonim
ned�l�	namikoni
ned�l�te	namikonid
ned�l�val	namikard
ned�l�val jsem	namikardam
ned�l�val jsi	namikardi
ned�l�vali	namikardand
ned�l�vali jsme	namikardim
ned�l�vali jste	namikardid
ned�le	yek�anbe
neexistuje	namib�ad
neexistujeme	namib�im
neexistuje�	namib�i
neexistujete	namib�id
neexistuji	namib�am
neexistuj�	namib�and
nefrit	ya�m
nehraje	b�zi namikonad
nehrajeme	b�zi namikonim
nehraje�	b�zi namikoni
nehrajete	b�zi namikonid
nehraji	b�zi namikonam
nehraj�	b�zi namikonand
nehr�l	b�zi nakard
nehr�l jsem	b�zi nakardam
nehr�l jsi	b�zi nakardi
nehr�li	b�zi nakardand
nehr�li jsme	b�zi nakardim
nehr�li jste	b�zi nakardid
nehr�val	b�zi namikard
nehr�val jsem	b�zi namikardam
nehr�val jsi	b�zi namikardi
nehr�vali	b�zi namikardand
nehr�vali jsme	b�zi namikardim
nehr�vali jste	b�zi namikardid
nechce	namix�had
nechceme	namix�him
nechce�	namix�hi
nechcete	namix�hid
nechci	namix�ham
necht�j�	namix�hand
necht�l	nax�st
necht�l jsem	nax�stam
necht�l jsi	nax�sti
necht�li	nax�stand
necht�li jsme	nax�stim
necht�li jste	nax�stid
nechvaln�	badbaxt
n�jak	yekjur
n�jak�	-i, andaki, -yi, p�reyi
nejasn�	�lude
nejbli���	nazdiktarin
nejdra���	ger�ntarin
nejd��ve	zudtarin
nejed�	namix�rand
nejedl	naxord
nejedl jsem	naxordam
nejedl jsi	naxordi
nejedli	naxordand
nejedli jsme	naxordim
nejedli jste	naxordid
nejhor��	badtarin
nej�	namix�rad
nej�m	namix�ram
nej�me	namix�rim
nej�	namix�ri
nej�te	namix�rid
nejkrat��	kut�htarin
nejlep��	behtaring, behtarin
nejlevn�j��	arz�ntarin
nejmen��	kucaktarin, xordtarin
nejsem	nistam
nejsem d�l�n	karde nami�avam
nejsem d�l�v�n	karde nami�odam
nejsem ud�l�n	karde na�ode'am
nejsi d�l�n	karde nami�avi
nejsi d�l�v�n	karde nami�odi
nejsi ud�l�n	karde na�ode'i
nejsme d�l�ni	karde nami�avim
nejsme d�l�v�ni	karde nami�odim
nejsme ud�l�ni	karde na�ode'im
nejsou d�l�ni	karde nami�avand
nejsou d�l�v�ni	karde nami�odand
nejsou ud�l�ni	karde na�ode'and
nejste d�l�ni	karde nami�avid
nejste d�l�v�ni	karde nami�odid
nejste ud�l�ni	karde na�ode'id
nejv�t��	bozorgtarin
n�kde	yek j�yi
n�kdo	yek kasi
neklidn�	bi�ram
n�kolik	cand
nekone�n�	bip�y�n
n�kter�	p�reyi
N�mecko	�lm�n
n�meck�	�lm�ni
nemocnice	bim�rest�n
nemocn�	bim�r
nenap�jel jsem se	nami��midam
nenap�jel jsi se	nami��midi
nenap�jel se	nami��mid
nenap�jeli jsme se	nami��midim
nenap�jeli jste se	nami��midid
nenap�jeli se	nami��midand
nen� d�l�n	karde nami�avad
nen� d�l�v�n	karde nami�od
nen� ud�l�n	karde na�ode'ast
nen� za�	x�he� mikonam
nepije	nami��mad
nepijeme	nami��mim
nepije�	nami��mi
nepijete	nami��mid
nepiji	nami��mam
nepij�	nami��mand
nepil	nay��mid
nepil jsem	nay��midam
nepil jsi	nay��midi
nepili	nay��midand
nepili jsme	nay��midim
nepili jste	nay��midid
nepo��t�	nami�omorad
nepo��taj�	nami�omorand
nepo��tal	na�omord
nepo��tal jsem	na�omordam
nepo��tal jsi	na�omordi
nepo��tali	na�omordand
nepo��tali jsme	na�omordim
nepo��tali jste	na�omordid
nepo��t�m	nami�omoram
nepo��t�me	nami�omorim
nepo��t�	nami�omori
nepo��t�te	nami�omorid
nepoj�d�	namixord
nepoj�dal	namixord
nepoj�dal jsem	namixordam
nepoj�dal jsi	namixordi
nepoj�dali	namixordand
nepoj�dali jsme	namixordim
nepoj�dali jste	namixordid
nepoj�d�m	namixordam
nepoj�d�me	namixordim
nepoj�d�	namixordi
nep�ich�zej�	nami�yand
nep�ich�z�	nami�yad
nep�ich�z�m	nami�yam
nep�ich�z�me	nami�'im
nep�ich�z�	nami�'i
nep�ich�z�te	nami�'id
nep�ijde	nax�had �mad
nep�ijdeme	nax�him �mad
nep�ijde�	nax�hi �mad
nep�ijdete	nax�hid �mad
nep�ijdou	nax�hand �mad
nep�ijdu	nax�ham �mad
nep�in�ej�	nami�rand
nep�in�el	nami�vard
nep�in�el jsem	nami�vardam
nep�in�el jsi	nami�vardi
nep�in�eli	nami�vardand
nep�in�eli jsme	nami�vardim
nep�in�eli jste	nami�vardid
nep�in��	nami�rad
nep�in��m	nami�ram
nep�in��me	nami�rim
nep�in��	nami�ri
nep�in��te	nami�rid
nep�inese	nax�had �vard
nep�ineseme	nax�him �vard
nep�inese�	nax�hi �vard
nep�inesete	nax�hid �vard
nep�inesl	nay�vard
nep�inesl jsem	nay�vardam
nep�inesl jsi	nay�vardi
nep�inesli	nay�vardand
nep�inesli jsme	nay�vardim
nep�inesli jste	nay�vardid
nep�inesou	nax�hand �vard
nep�inesu	nax�ham �vard
nep�i�el	nay�mad
nep�i�el jsem	nay�madam
nep�i�el jsi	nay�madi
nep�i�li	nay�madand
nep�i�li jsme	nay�madim
nep�i�li jste	nay�madid
nep��tel	do�man
neradostn�	badbaxt
nerez ocel	pul�d e bizang
nerv	pey, asab
nervov�	asabi
nesm�rn�	bi� az and�ze
nesn�dl	naxorde'ast
nesn�dl jsem	naxorde'am
nesn�dl jsi	naxorde'i
nesn�dli	naxorde'and
nesn�dli jsme	naxorde'im
nesn�dli jste	naxorde'id
nespal	nax�bid
nespal jsem	nax�bidam
nespal jsi	nax�bidi
nespali	nax�bidand
nespali jsme	nax�bidim
nespali jste	nax�bidid
nesp�val	namix�bid
nesp�val jsem	namix�bidam
nesp�val jsi	namix�bidi
nesp�vali	namix�bidand
nesp�vali jsme	namix�bidim
nesp�vali jste	namix�bidid
nesp�	namix�bad
nesp� (pl.)	namix�band
nesp�m	namix�bam
nesp�me	namix�bim
nesp�	namix�bi
nesp�te	namix�bid
neud�lal	nakarde'ast
neud�lal jsem	nakarde'am
neud�lal jsi	nakarde'i
neud�lali	nakarde'and
neud�lali jsme	nakarde'im
neud�lali jste	nakarde'id
neur�it� �len (jeden	-i, -yi
nev�d�l	nad�nest
nev�d�l jsem	nad�nestam
nev�d�l jsi	nad�nesti
nev�d�li	nad�nestand
nev�d�li jsme	nad�nestim
nev�d�li jste	nad�nestid
nev�d�	namid�nand
nev�	namid�nad
nevidom�	n�bin�
nev�m	namid�nam
nev�me	namid�nim
nev�	namid�ni
nev�te	namid�nid
nevyjasn�n�	�lude
nezav�r�	namibandad
nezav�raj�	namibandand
nezav�ral	namibast
nezav�ral jsem	namibastam
nezav�ral jsi	namibasti
nezav�rali	namibastand
nezav�rali jsme	namibastim
nezav�rali jste	namibastid
nezav�r�m	namibandam
nezav�r�me	namibandim
nezav�r�	namibandi
nezav�r�te	namibandid
nezav�el	nabast
nezav�el jsem	nabastam
nezav�el jsi	nabasti
nezav�eli	nabastand
nezav�eli jsme	nabastim
nezav�eli jste	nabastid
nezbytn�	l�zem
ne�	az
ne�it	kurak, domal
nic	hic
nicm�n�	b� vojude in
nikdy	hargez
nit	nax
n�e	p�yine, zire
noc	�ab
noha	p�, s�q
norm�ln�	�di
norsk�	norve�i
nos	bini, dam�q
nosi� zavazadel	b�rbar
notes	daftarce
nouzov� v�chod	pelle ye goriz
novinov� st�nek	ruzn�meforu�i
noviny	ruzn�me
nov�	now, t�ze
Nov� rok	S�l e Now
nula	sefr
nutno	b�yad
nutn�	l�zem
n��ky na nehty	qeyci ye n�xon
nylon	n�ylon
nyn�	h�l�, aknun
o	darb�re, gerd�gerd, r�je'be, darb�reye
�!	h�!
oba	har do
obalit	picidan
ob�lka	p�kat
ob�an	�ahrund
ob�ansk� pr�kaz	�en�sn�me
obd�l�vat	ke�t kardan
obd�ln�k	mostatil
obdob�	�v�m
ob�	har do
ob�d	n�h�r, nah�r
ob�	qorb�n
obez�etnost	ehtiy�t
obchod	maq�ze, foru�g�h
obiln� pole	ke�tz�r e zorrat
obinadlo	b�nd e zaxm
objednat	sef�re� d�dan
objedn�vat	sef�re� d�dan
objevit	k�ef kardan
objevitel	k�ef
obj��ka	enher�f
oblek	kot o �alv�r (dast~)
obli�ej	cehre, surat
obo��	abru
oboj�	har do
obraz�rna	neg�rest�n
obrovsk�	m�zandar
obsadit	e�q�l kardan
obt�ovat	zahmat d�dan
obt�	do�v�ri
obvaz	b�nd e zaxm
ocet	serke
o�n� kapky	qatre ye ce�m
o�n� linky	xatt e ce�m
o�n� st�ny	s�ye ye ce�m
od	az, x�mu�, ken�r, durtar, jod�
od t� doby� co	az hang�mi ke
odcizit	dozdidan
odjezd	harakat
odkazovat	vaqf kardan
odlakova�	l�kp�kkon
odpoledne	pas az nimruz, ba'd az zohr
odpov��	p�sox
odpov�d�l	p�sox d�d
odpov�d�l jsem	p�sox d�dam
odpov�d�l jsi	p�sox d�di
odpov�d�li	p�sox d�dand
odpov�d�li jsme	p�sox d�dim
odpov�d�li jste	p�sox d�did
odpov�d�t	p�sox d�dan
odpov�d�	p�sox x�hand d�d
odpov�z	p�sox bede
odpov�	p�sox x�had d�d
odpov�d�	jav�b midahad
odpov�daj�	jav�b midahand
odpov�dal	jav�b d�d
odpov�dal jsem	jav�b d�dam
odpov�dal jsi	jav�b d�di
odpov�dali	jav�b d�dand
odpov�dali jsme	jav�b d�dim
odpov�dali jste	jav�b d�did
odpov�d�m	jav�b midaham
odpov�d�me	jav�b midahim
odpov�d�	jav�b midahi
odpov�dat	jav�b d�dan
odpov�d�te	jav�b midahid
odpov�dej	jav�b bede
odpov�m	p�sox x�ham d�d
odpov�me	p�sox x�him d�d
odpov�	p�sox x�hi d�d
odpov�te	p�sox x�hid d�d
odst�n	rang e raqiq
ohe�	�ta�
ohniv�	�ta�in
okno	panjare, panjere
oko	ce�m
okolo	atr�f, gerd�gerd, pir�mun
okoun	m�hi ye x�rd�r
okrouhl�	gerd
okurka	xiy�r
okurka (mal�	xiy�r e �ur
olej	rowqan
olejov�	rowqani
oliva	zeytun
olivov� olej	rowqan e zeytun
om��ka	sos
omastek	corbi
omastit	corb kardan
omdlen�	qa�
omdl�vat	qa� nemudan
omeleta	omlet
omluva	puze�
omyl	�rang
on	vey, u
ona	u
ona (pl.)	�nh�
oni	i��n, �nh�, �n�n
oni (pro osoby)	i��n
ono	�n
onomu	be�n
ony	�nh�
onyx	aqiq e soleym�ni
op�len�	�ft�bsuxtegi, �ft�bsuxtagi
opalovac� kr�m / ml�ko	kerem e �ft�b
opatrnost	ehtiy�t
oper�tor	telefonci
op�t	dob�re
opice	meymun, buzine
oprava	tamir
opravna (d�lna)	tamirg�h
oran�ov�	n�ranji
orat	ke�t kardan
ornitologie	parande�en�si
osa	mehvar
oslniv� kr�sa	afsungari
osm	ha�t
osm set	ha�tsad
osmdes�t	ha�t�d
osmina	ha�tom
osmn�ct	hejdah
osm�	ha�tom
osoba	�axs, fard
osobit�	fardi, �axsi
osobn�	�axsi, fardi
osobn� sluha	pi�xedmat
osoby	a�x�s
ostru�ina	��htut
ostr�	tond, tiz
ostuda	�arm
osv�d�en�	gov�hin�me
otec	pedar
ot�kat	�m�s kardan
otev�en�	b�z
otok	�m�s
otrava	masmumiyat e qaz�yi
ov�d	xarmages
ov�l	beyzi
ovce	gusfand
ovl�dat	balad budan
ovoce	mive
ozbrojen�	mosallah, zin�vand
ozn�men�	tavajjoh
ozvu�en�	ostov�r
padat	oft�dan
pades�t	panj�h
pal�c	k�x
palec	�ast
Palestina	Felestin, Palestin
palivo	suxt
pam�	y�d
pan	�q�
P�n	Xod�vand
p�n	farm�nrav�, �ahry�r
p�nev	t�be
pan�	x�nom
p�ni	�q�y�n
p�nov�	�q�y�n
Panovn�k	Xod�vand
pantofel	damp�yi
pantofle	joft damp�yi
pap�r	k�qaz
pap�rnictv�	neve�tafz�rforu�i
pap�rov� ubrousek	dastm�l e k�qazi
papou�ek	tuti
paprsek	partow
p�r	joft
p�rek v rohl�ku (housce)	h�td�g
parf�m	atr
park	p�rk
parkovat	p�rk kardan
parkovi�t�	p�rking
parn�k	ka�ti
pasa��r	mos�fer
p�sek	kamarband
p�sek (hod.)	band e s�at
past	d�m
pastelka	qalam, qalam e naqq�i
pastilky proti ka�li	qors e sorfe
past��	�ab�n
pa�tika	p�te
pata	p�ne
p�tek	�dine, jom'e
p�te�	sotun e faqar�t
patn�ct	p�nzdah
patro	tabaqe
p�t�	panjom
pa�e	b�zu
ped�l (u bicyklu)	rek�b
ped�l plynu	ped�l e g�z
pek�rna	n�nv�yi
peka�stv�	n�nv�yi
peler�na	�enel
pep�	felfel
pep�it	felfel zadan
perla	morv�rid, marv�rid
pero	xodk�r, xodnevis, par
p�rov�n�	fanar
persk�	f�rsi
pes	sag
p�ky	piy�de
p�t	panj
p�t set	p�nsad
p�tina	panjom
pevnost	de�
pije	mi��mad
pijeme	mi��mim
pije�	mi��mi
pijete	mi��mid
piji	mi��mam
pij�	mi��mand
pil	��mid
pil jsem	��midam
pil jsi	��midi
pili	��midand
pili jsme	��midim
pili jste	��midid
pilka	arre
piln��ek na nehty	somb�de ye n�xon
pinzeta	mucin
p�smeno	harf
p�smo	xatt
p�st	piston
p�t	��midan
pit�	nu�idani
pitn� voda	�b e ��midani
pivo	�bjo, �b e jow
pizza [pica]	pitz�
pl��	gerye
plachetnice	q�yeq e b�di
plachta	b�db�n
pl�n	naq�e
pl�n m�sta	naq�e ye �ahr
plant�	ke�tz�r
plastick� guma	ke�
pl�t�nka	b�r�ni
platina	pl�tin
pl�tno	p�rce ye kat�ni, panbeyi
plat�s	m�hi ye pahn
plav�	zard e kamrang
plavat	�en� kardan
plavky	l�s e �en�, m�yo
pl�	s�hel
plechovka	quti
plemeno	ne��d
plenka	kohne ye bacce
plenky	dastm�l e bacce
pl�ce	�o�
pln�	por, anb�te, labriz
plod	mive
plot	parcin
pls�	namad
pluk	hang
plyn	g�z
po	pas
po (lok�l)	ba'ad�z
po (pod�l)	hamr�h, jelow, pi�
po (potom)	pas az, dar jostojuye, dar peye
pob�e��	s�hel, ken�r e dary�
po��tek	ebted�
po��t�	mi�omorad
po��taj�	mi�omorand
po��tal	�omord
po��tal jsem	�omordam
po��tal jsi	�omordi
po��tali	�omordand
po��tali jsme	�omordim
po��tali jste	�omordid
po��t�m	mi�omoram
po��t�me	mi�omorim
po��t�	mi�omori
po��tat	�omordan
po��t�te	mi�omorid
po�kej	sabr kon
pod	zir, p�yin, p�yine, p�eyn, zire
podivn�	�egeft
podkladov� kr�m	kerem e zir
podnik	�erkat
podoba	�ekl
podpis	emz�
pod��vka	�star
podu�ka	n�zb�le�
podzim	p�yiz
poh�r	fenj�n
pohlednice	k�rtpost�l
pohrani��	marzi
pohroma	�fat
pochybnost	�ak
pochybovat	�ak kardan
poj�dal	mixord
poj�dal jsem	mixordam
poj�dal jsi	mixordi
poj�dali	mixordand
poj�dali jsme	mixordim
poj�dali jste	mixordid
poker [pokr]	poker
poklad	ganj, ganjine, xaz�ne
poklid	�r�me�, �sudegi
pokoj	ot�q, �r�me�, �ti, �s�ni
pokojsk�	xedmatk�r
pokrm	qaz�, xor�k
pokro�il�	pi� oft�de, pi� rafte
poku�en�	�zm�ye�, varan, farib, havas
pole	ke�tz�r
poledne	nimruz, rabih
pol�vka	�urb�, �, �bgu�t
police	qafase
policejn� stanice	p�sg�h e polis
policie	polis
policista	p�sb�n
poli�ka	qafase
poliklinika	darm�ng�h
politick� strana	hezb
polovi�n�	nime
polovina	nim
pol�t��	b�le�
pom�hat	komak kardan
pomalu	yav�, �heste
pomal�	�heste, yav�
pomeran�	n�ranj, portaq�l
pomeran�ov� ���va	kadu ye halv�yi
pomez�	vimand
poml�t	kubidan
pomoc	y�ri, komak
pond�l�	do�anbe
pon�vad�	conke
pon�en� (adj.)	mostaz'afin
pono�ka	jur�b
pono�ky	joft jur�b
popeln�k	j�sig�ri
poplatek	hazine
popul�rn� hudba	musiqi ye p�p
p�r	tare (ye farangi)
porazit	ri�ekan kardan, darham �ekastan
p�rek	tare (ye farangi)
porodnice	z�ye�g�h
posel	peyk
poschod�	tabaqe
pos�lat	ferest�dan
poslechnout	gu� d�dan
posl��ek	��gerd, p�dow
poslouchat	gu� kardan
postel	taxtex�b, raxtex�b
postihnout	asar kardan
po�kodit	ziy�n zadan
po�li	beferest
po�ta	ed�re ye post, postx�ne
po�tovn� ��ad	ed�re ye post
po�tovn� v�z	v�gon e b�ri
pot�iteln�	xo�
pot�	do�v�ri
potkan	xarmu�
potla�it	forune��ndan, sarkubi kardan
potok	juy, juyb�r
potom	pas, sepas
potrava	qaz�
potrub�	lule
pot�ebn�	l�zem
pou��	sahr�
pouto	band
pouze	tanh�, yeg�ne
pou�it� zbo��	dast e dovom
povaha	mane�
pov�d�t	goftan
pov�dat	goftogu kardan
pov�dka	afs�ne
pozd�ji	pas, sepas
poz�t��	pasfard�
pozn�n�	�n�yi
po�ehn�n�	barekat
po�ehnan�	xojaste, farxonde, k�mrav�
po�ehnat	barekat d�dan
prababi�ka	m�dar-m�darbozorg
pr�ce	zist, k�r
pracovat	k�r kardan
pracovn�	zist
pracovn� den	ruz e k�r
prad�de�ek	pedar-pedarbozorg
pr�delna	raxt�uyx�ne
pramen	ce�me
pr�ek na span�	qors e x�b�var
pravda	dorosti, r�sti
pravit	goftan
pr�vo	haqq
prav�	r�st
pr�zdn�	x�li
preferovat	tarjih d�dan
prchaj�c�	gorizande, �v�re, sargard�n
princ	��hz�de
pro	bar�ye, bar�ye inke, darpey
pro(to�e)	con
pro�	cer�
prodat	foruxtan
prodava�ka	foru�ande
prod�vat	foruxtan
prodej	foru�
prodejna	maq�ze, foru�g�h
prodejna potravin	baqq�l
profese	herfe
program	barn�me
programovat	barn�me neve�tan
prohibice	b�zd�ri
proj�madlo	moshel
prominout	bax�idan, bax�udan, �morzidan
promi�te	puze� mix�ham, bebax�id
pronajmout	ej�re kardan
prorok	pay�mbar
pros�m	lotfan, x�he� mikonam
prosinec	des�mbr
prosit	x�he� nemudan
proslul�	ma�hur
prost�	s�de
prot�j��	ruberu
proti	darbar�bar, zedde, pady�r
proto�e	conke, zir�
prozat�m	hanuz
prsa	pest�n, sine
prst	ango�t
prst u nohy	ango�t e p�
prsten	halqe, ango�tar
pr�et	b�r�n �madan
prudk�	tond
pr�hledn�	�aff�f
pr�jem	esh�l
pr�jezd	gozar
pr�kaz	gov�hin�me
pr�klepov� pap�r	meqd�r k�rbon
pr�liv	k�n�l
pr�plav	�br�h
pr�svitn�	�aff�f
pru�en�	fanar
pru�ina	fanar
prvn�	naxost, avval
Prvn� jarn� den	Nowruz
prvn� t��da	daraje ye yek
pry�	dur, jod�, ken�r, x�mu�, durtar
p��t	�rezu kardan
p��telstv�	dusti
p�ebrat	radif kardan
p�ed	pi� az, pi�
p�ed (s akuzativem)	jelow
p�edb�n� opat�en�	moqaddam�t
p�ed�asn�	n�behang�m
p�ed�asn�	n�behang�m
p�edem	pi� az
p�edkl�dat	taqdim d�tan
p�edkrm	pi�p�re, pi�qaz�
p�edmluva	dib�ce
p�edpis	�yinn�me
p�edpov��	pi�bini
p�edprodej	pi�foru�
p�edstavitel	nam�yande
p�ed�koln�	pi�dabest�ni
p�edv�le�n�	pi� az jang
p�edv�st	ne��n d�dan
p�edv�dat	pi�bini kardan
p�eh��ka	ragb�r
p�ehoz	�enel
p�eklad	tarjome
p�ekl�dat	tarjome kardan
p�elo�it	tarjome kardan
p�em�hat	cire �odan
p�emoci	piruz �odan
p�em��let	fekr kardan
p�epis	pacin
p�epln�n�	labriz
p�epo��t�vat	dob�re �omordan
p�es	sart�sar, azmiy�n, abar, ruyi
p�esto	harcand
p�esto�e	agarce
p�esv�d�en�	im�n
p�evodovka	ja'be dande
p�ezka	sagak e kamarband
p�ezkou�et	�zm�ye� kardan
p�ezout se	kaf� dar �vardan
p�ezouvat se	dar �vardan kaf�
p�ez�vky	g�le�
p�i	bedaste, nazdik, darpahluye, dar ken�r, dame
p�ib�jet	mix kardan
p�ib�t	kubidan
p�ibl�it	nazdik �odan
p�ibli�n�	nazdik be
p���ka	narde
p��davn� jm�no	sefat
p�ihr�vat	ferest�dan, p�s d�dan
p�ihr�vka	p�s
p�ich�zej�	mi�yand
p�ich�zel	mi�mad
p�ich�zel jsem	mi�madam
p�ich�zel jsi	mi�madi
p�ich�zeli	mi�madand
p�ich�zeli jsme	mi�madim
p�ich�zeli jste	mi�madid
p�ich�zet	�madan
p�ich�z�	mi�yad
p�ich�z�m	mi�yam
p�ich�z�me	mi�yim
p�ich�z�	mi�yi
p�ich�z�te	mi�yid
p��chod	vorud
p�ijat� uchaze�	gom�rde
p�ijde	x�had �mad
p�ijdeme	x�him �mad
p�ijde�	x�hi �mad
p�ijdete	x�hid �mad
p�ijdou	x�hand �mad
p�ijdu	x�ham �mad
p��jemn�	xo�
p��jezd	vorud
p�ij�t	�madan
p��krm	pi�qaz�
p��mka	xatt e r�st
p��m�	mostaqim
p�in�ej�	mi�rand
p�in�el	mi�vard
p�in�el jsem	mi�vardam
p�in�el jsi	mi�vardi
p�in�eli	mi�vardand
p�in�eli jsme	mi�vardim
p�in�eli jste	mi�vardid
p�in�et	�vardan
p�in��	mi�rad
p�in��m	mi�ram
p�in��me	mi�rim
p�in��	mi�ri
p�in��te	mi�rid
p�inese	x�had �vard
p�ineseme	x�him �vard
p�inese�	x�hi �vard
p�inesete	x�hid �vard
p�inesl	�vard
p�inesl jsem	�vardam
p�inesl jsi	�vardi
p�inesli	�vardand
p�inesli jsme	�vardim
p�inesli jste	�vardid
p�inesou	x�hand �vard
p�in�st	�vardan
p�inesu	x�ham �vard
p��platek za prvn� t��du	ez�fe-qeymat e daraje ye yek
p��slovce	band, sarf, qeyd
p��slu�n�k	and�m
p��stav	bandar
p�i�el	�mad
p�i�el jsem	�madam
p�i�el jsi	�madi
p�i�li	�madand
p�i�li jsme	�madim
p�i�li jste	�madid
p��tel	dust
p�iv�st	�vardan
p�iv�zt	�vardan
p��ze�	eltef�t, y�ri
ps�t	neve�tan
pstruh	m�hi ye qezel�l�
p�enice	gandom
pt� se	miporsad
ptaj� se	miporsand
ptal jsem se	porsidam
ptal jsi se	porsidi
ptal se	porsid
ptali jsme se	porsidim
ptali jste se	porsidid
ptali se	porsidand
pt�m se	miporsam
pt�me se	miporsim
pt� se	miporsi
pt�t se	porsidan
pt�te se	miporsid
ptej se	bepors
pudr	pudr, gard e surat
p�jde	x�had raft
p�jdeme	x�him raft
p�jde�	x�hi raft
p�jdete	x�hid raft
p�jdou	x�hand raft
p�jdu	x�ham raft
p�l	nim
pumpa	pomp
pun�ochy	jur�b e zan�ne (joft~)
pytel	kise
py�amo	pi��me
r�d	xorsand
radi�tor	radi�tor, r�diy�tor
r�dio	r�diyo
radnice	�ahrd�ri
r�do se stalo	x�he� mikonam
rag�	xore�
raj�e	gowje ye farangi
rajsk� jablko	gowje ye farangi
raketa	�ta�afr�ze, r�ket
raketa (tenisov�)	cowg�n
rakovina	sarat�n
rameno	du�, ��ne
r�no	sobh
r�en�	pand
rebarbora	riv�s
recept	nosxe
redukce	k�he�
rek	pahlav�n
reklama	�gahi
r�serv�	reserv�siyon
restaurace	rastur�n
ret	lab
reve�	riv�s
revmatismus	rom�tism
rezervace	reserv�siyon
rezervovan�	rezerv �ode
rezervovat	rezerv kardan
ricinov� olej	rowqan e karcak
rij�l	riy�l
robot	�dam e �hani
robustn�	nirumand
ro�enka	s�ln�me
ro�n�	s�liy�ne
rod	ne��d
rodina	x�nev�de
roh	��x
rok	s�l
rostlina	nab�t
roura	lule
rovn�	ham
rovn�	mostaqim
rozb�jet	�ekastan
rozb�t	�ekastan
rozd�l	farq
rozdrtit	ri�ekan kardan, darham �ekastan
rozhn�van�	asab�ni
rozhovor	goftogu
rozm�r	and�ze
rozpr�it	darham �ekastan, ri�ekan kardan
rozum�t	fahmidan
rozzloben�	xa�mgin
rt�nka	m�tik, ru�
rub�n	y�qut
ru�n� pr�ce	k�r e dast
ru�n� zavazadlo	asb�b e dast
ru�n�k	howle
rud�	sorx
ruka	dast
ruk�v	�stin
rukavice	dastke�
Rusko	Rusiyye
ru�n�	�oluq
r��	m�tik, ru�
r��ov�	surati, goli
ryb�rna	m�hiforu�i
ryba�en�	m�higiri
rybn�k	berke
r��	bil
rychl�k	qat�r e tondrow
rychl�	tond, sarih
r��e	berenj
�adic� p�ka	dande
�editel	modir
�edkev	torob
�edkvi�ka	torobce
�eka	rudx�ne
�epa	coqandar
�et�z	zanjir
�et�zov�	zanjiri
�ezal	bord
�ezal jsem	bordam
�ezal jsi	bordi
�ezali	bordand
�ezali jsme	bordim
�ezali jste	bordid
�ezat	boridan
�ez�val	mibord
�ez�val jsem	mibordam
�ez�val jsi	mibordi
�ez�vali	mibordand
�ez�vali jsme	mibordim
�ez�vali jste	mibordid
�ezej	bebor
�eznictv�	qass�bi, gu�tforu�i
�e�	bebor
�e�e	mibarad
�e�eme	mibarim
�e�e�	mibari
�e�ete	mibarid
�e�ou	mibarand
�e�u	mibaram
��ct	goftan
�idi�	r�nande
�idi�sk� pr�kaz	gov�hin�me ye r�nandegi
��dit (auto)	r�nandegi kardan
��jen	oktobr
��k�	miguyad
��kaj�	miguyand
��kal	goft
��kal jsem	goftam
��kal jsi	gofti
��kali	goftand
��kali jsme	goftim
��kali jste	goftid
��k�m	miguyam
��k�me	migu'im
��k�	migu'i
��kat	goftan
��k�te	migu'id
��zen�	farm�n
s	b�
sad	b�qmive
s�dra	gac
saf�r	y�qut e kabud
sako	kot
s�l	s�lon
sal�m	sosis, k�lb�s
sal�t	s�l�d
salon	s�lon
salon kr�sy	s�lon e zib�yi
s�m	tanh�
samet	maxmali
samohl�ska	b�sed�
samohl�skov�	�v�d�r
samoobsluha	superm�rket
sanatorium	�s�ye�g�h
sand�l	sandal
sand�ly	joft sandal
S�ra	S�r�
sardel	m�hi ye kuli
sardinka	s�rdin
satan	�eyt�n
sat�n	p�rce ye abri�am e masnui, s�tan
sazba	hazine
saze	dude
s�zet	k�tan
sbohem	Xod� negahd�r
sborn�k	s�ln�me
s��t�n�	sar�om�ri, �m�rgiri
se	xod
se�	be�in
sedativum	mosakken
sed�t	ne�astan
sedlo	zin
sedm	haft
sedm set	haftsad
sedmdes�t	haft�d
sedmina	haftom
sedmn�ct	hefdah
sedm�	haftom
sekera	tabar, ti�e
sekret��ka	mon�i
sekunda	s�niye
semi�	jir
sen	x�b
sendvi�	s�ndvic
senn� r�ma	tab e nowbe, tab e �adid
seri�l	po�t e sareham
servis	servis
ser�ant	goruhb�n
sestra	x�har
sest�enice	doxtar-e-x�le, amuz�de, doxtar-e-amme
se�it	daftar e pi�nevis
setina	sadom
sever	ab�xtar, �om�l
severn�	ab�xtari
sezn�men� (se)	�n�yi
sez�na	fasl
shodn�	yeks�n
si	xod
s�la	niru, tav�n
silnice	j�dde
s�	tur
s�to	alak
sjednocovat	yeki �odan
sjednotit	yeki kardan, beham peyvastan
skic�k	k�qaz e pi�nevis
sklenice	liv�n
sklenka	liv�n
sklize�	xarman
sklo	�i�e
sklon	�ib
skonat	mordan
sko�ice	d�rcin
skript	xatt
skr�vat	penh�n �odan
skrz	azmiy�n, sart�sar
sk���	e�k�f, ganje
sk�ivan	cak�vak
skvost	gowhar
slabik��	ket�b e alefb�yi
slab�	naz�r, kamzur, n�tav�n
sladk�	�irini
sladkost	�irini
sl�ma	k�h
slan�	namakd�r, �ur
sl�va	far, �okuh, farrah
sle�na	du�ize
sle�	m�rm�hi, ��hm�hi
slep�	kur
slib	va'de
sl�va	gowje
slon	fil
slova	loq�t
slovn�k	farhang
slovo	laqat, v�e, kaleme
slo�ka	pu�e
sluka lesn�	xorus e jangali
slunce	xor, xor�id, �ft�b
slune�n�k	s�yeb�n
slu�n�	�arif
slu�ba	servis
sly�	be�no
sly�el	�enid
sly�el jsem	�enidam
sly�el jsi	�enidi
sly�eli	�enidand
sly�eli jsme	�enidim
sly�eli jste	�enidid
sly�et	�enidan
sly��	mi�enavad
sly�� (pl.)	mi�enavand
sly��m	mi�enavam
sly��me	mi�enavim
sly��	mi�enavi
sly��te	mi�enavid
slza	�k
smalt	min�k�ri
smaragd	zomorrodin, zomorrod
sm�t se	xandidan
sm�n�rna	sarr�fi
sm�rem k	be, dar r�he, darb�reye, besuye
sm�st	j�rub kardan
smet�k	j�rub
smetana	x�me
sm�en� zbo�� (prodejna)	x�rob�rforu�i
smrk	��hdaraxt
smrt	marg
smrteln�	margb�r
smutek	qam, anduh
snad	��yad
snadno	be �s�ni
snadn�	s�de
sna�it se	ku�idan
sn�dl	xorde'ast
sn�dl jsem	xorde'am
sn�dl jsi	xorde'i
sn�dli	xorde'and
sn�dli jsme	xorde'im
sn�dli jste	xorde'id
sn�it	barf �madan
sn�dan�	sobh�ne
sn�h	barf
sn�en�	k�he�
snoubenec	n�mzed
snubn� prsten	halqe ye n�mzedi
sobota	�anbe
socha�stv�	tandiss�zi
s�ja	soy�
sojka	z�qkabud
solen�	namakd�r, namaki
soud	d�dg�h, qaz�vat
soudce	q�zi
souhl�ska	harf e bised�
soukol�	dande
soulo�it	g�yidan
soulo�it (vulg.)	g�yidan
soumrak	t�rik e row�an
soupe�	harif
spac� pytel	kise ye x�b
spal	x�bid
spal jsem	x�bidam
spal jsi	x�bidi
sp�len� (slun.)	�ft�bsuxtagi
spali	x�bidand
spali jsme	x�bidim
spali jste	x�bidid
spalni�ky	sorxak
sp�sa	rasteg�ri
sp�t	x�bidan
spat�ovat	negaristan
sp�val	mix�bid
sp�val jsem	mix�bidam
sp�val jsi	mix�bidi
sp�vali	mix�bidand
sp�vali jsme	mix�bidim
sp�vali jste	mix�bidid
sp�ch	�et�b
spi	bex�b
sp�	mix�bad
sp� (pl.)	mix�band
sp�m	mix�bam
sp�me	mix�bim
spir�la	m�rpic
spiritualita	minuyi
sp�	mix�bi
sp�te	mix�bid
spl�st se	e�teb�h namudan
spln�n�	ras�yi, �zg�r, p�y�n
spojit	beham peyvastan
spojka	kel�, kl�c
spole�n�	b�ham
spole�nost (obchodn�)	�erkat
spolkov�	feder�l
spolu	b�ham
spona	sagak e kamarband
sponka	cangzan
sponzor	esponsor
sport	varze�
spr�vce	modir
spravedliv�	�del
spravedlnost	adl, ed�lat
spropitn�	en'�m
sp��dat	b�ftan
Srbsko	Serbest�n
srdce	del, qalb
srp	d�s
srpen	ut
stadion	varze�g�h
stal jsem se	�odam
stal jsi se	�odi
stal se	�od
stali jsme se	�odim
stali jste se	�odid
stali se	�odand
stan	c�dor
stanice	istg�h
stanovi�t�	tavaqqofg�h
startov�n�	est�rt
star�	pir
st�t se	�odan
stativ	sep�ye
statn�	nirumand
statut	as�sn�me
st�v� se	mi�avad
st�vaj� se	mi�avand
st�v�m se	mi�avam
st�v�me se	mi�avim
st�v� se	mi�avi
st�vat se	�odan
st�v�te se	mi�avid
steak [stejk]	esteyk
st�blo	k�h
stehno	r�n
st�hovat se	asb�b ke�idan
stejn�	me��be, yeks�n
stejn�	yeks�n, me��be
st�na	div�r
st�nat	n�le kardan
st�ra�	barfp�kkon
stereofonn�	esteriyo
sterilizovat	esterlize kardan
steriln�	bib�r
stezka	r�h, piy�derow
st�n	s�ye
st�nit	s�ye and�xtan
stinn�	s�yed�r
st�rat	p�k kardan
stm�vat se	t�rik �odan
sto	sad
sto�it	lule kardan
stodola	anb�r
stojan	p�ye
stolet�	qarn
stonek	s�q
stop	ist
stopa	p�
sto��r	dagal
strach	tars
str��	�ib
stranick�	hezbi
strava	qaz�
str�n�k	p�sb�n
stroh�	tond
stroj	dastg�h
strojen�	s�xtegi
strojvedouc�	mob�er e qat�r
strojv�dce	mob�er e qat�r
strom	deraxt
stru�n�	kut�h, moxtasar
struna	zeh
str�c	d�yi, ammu
str�c z mat�iny strany	d�yi
str�c z otcovy strany	ammu
st�ed	miy�ne
st�ed m�sta	markaz e �ahr
st�eda	cah�r�anbe
st�echa	b�m
st�eln� prach	b�rut
st�evo	rude
st��bro	noqre
st��kat	p�idan
student	d�ne�ju
studen�	sard
stuha	rub�n, nav�r
st�l	miz
stu�ka	nav�r
sud	bo�ke
such�	xo�g
sukn�	d�man
s�l	namak
sult�n	solt�n
sup	karkas
supermarket	superm�rket
surfovac� [serfovac�] prkno	mowj�ekan
sval	azole
svat�	p�kd�man, p�k, moqaddas, avi�e
svazek	jeld
sv�r�zn�	vi�e
sv�t	jah�n, dony�
sv�tec	p�kd�man, a�u, parhizk�r
sv�tl�	row�an
sv�tlo	nur
sv�tl�	row�ani
sv�tov�	jah�ni
sv�tozn�m�	ma�hur
sv�tsk�	jah�ni, donyavi
sv�ce	�am'
sv�cen	�am'd�n
sv��ka	�am'
sv��kov�	gu�t e r�ste
svoboda	�z�di
svobodn�	�z�d
svrchn�k	sar�ane
syn	farzand, pesar
Syn Bo��	Farzand e Xod�
syn str�ce z mat�iny strany	pesar-e-d�yi
syn str�ce z otcovy strany	pesar-e-ammu
syn tety z mat�iny strany	pesar-e-x�le
syn tety z otcovy strany	pesar-e-amme
synagoga	paraste�g�h e yahudiy�n, kanise
synt�za	tarkib
sypat	p�idan
s�r	panir
syrov�	x�m
sysel	sanj�b
syst�m	sistem
systematick�	bar yek rave�
� (hl�ska)	� (horuf)
�ablona	neg�re
�achmat	m�t
�achta	c�l
�achy	�atranj
��l	��l
��la	��l, ��l e gardan
��lek	fenj�n
�ampa�sk�	��mp�yn
�ampion	pahlav�n
�ampon	��mpu
�anson	sorud
�ar�e	hazine
�at	leb�s
��tek	rusari
�atn��ka	leb�sd�r
�atn�k	ganje, e�k�f
�aty	leb�s, leb�sh�
�avle	�am�ir
�edes�t	�ast
�ed�	x�kestari
�ek	cek
�el	raft
�el jsem	raftam
�el jsi	rafti
�e��k	y�s
�est	�e�
�est set	�e�sad
�estina	�e�om
�estn�ct	��nzdah
�est�	�e�om
�ibenice	d�r
�ifon	p�rce ye harir e n�zok
��je	gardan
�ikovn�	m�har
��len�	div�ne
��let	div�ne �odan
�ilink	�iling
��p	tir
�ipka	nize
�irok�	go��d
��t	duxtan
�it�	duxte
�kared�	ze�t
�koda	ziy�n
�kola	�muze�g�h, madrese, dabest�n
�krob	ne��ste
�leha�ka	x�me ye zade
�li	raftand
�li jsme	raftim
�li jste	raftid
�ortky	�ort
�owhar	man�el
�patn�	bad
�pendl�k	sanj�q
�perkovnice	gowhard�n
�p�na	cerk
�pinav�	cerk
�roub	pic
�t�rk	�en
�tika	ordakm�hi
�t�r	ka�dom
��ov�k	tor�ak
�unka	��mbon
�vagr	bar�dar-e-zan, bar�dar-e-�owhar
�vagr (bratr mu�e)	bar�dar-e-�owhar
�vagr (bratr �eny)	bar�dar-e-zan
�vagrov�	x�har-e-�owhar, x�har-e-zan
�vagrov� (sestra mu�e)	x�har-e-�owhar
�vagrov� (sestra �eny)	x�har-e-zan
�vestka	�lu
ta	�n
tab�k (prodejna)	tamb�kuforu�i
tady	inj�
tahle	in
tachometr	kilometr-�om�r
tajemstv�	r�z
tak	conin, cand�n
tak�	ham, niz
takov�	cenin
tal��	bo�q�b
tam	�nj�
tamhle	�nj�
tamta	�n
tamten	�n
tamto	�n
ta�ka	kif
t�ta	b�b�
tato	in
taxa	hazine
taxi	t�ksi
taxik��	r�nande ye t�ksi
t�	tor�
tebe	tor�
te�	aknun, h�l�
Teher�n	Tehr�n
technologick�	teknolo�iki
tele	gus�le
telec� (maso)	gu�t e gus�le
telefon	telefon
telefonovat	telefon kardan
televize	televizion, televiziyon
televizor	televiziyon
t�lov� pudr	kerempudr
temn�	t�rik
ten	�n
tenhle	�n su, in
tenis	tenis
tenisky	kaf� e kat�ni (joft~), kaf� e tenis
tento	in
tent��	mesl in
teologie	xod�en�si
teplo	garm�
teplom�r	dam�sanj
tepl�	garm
tepna	��hrag
terasa	ter�s
termostat	termost�t
teryl�n	terlin
t�it se	lezzat bordan
teta	amme� x�le
teta z mat�iny strany	x�le
teta z otcovy strany	amme
text	motun
t�k�	sangin, mo�kel, saxt
tch�n	pedarzan� pedar�owhar, pedar-e-zan� pedar-e-�owhar
tch�n (otec mu�e)	pedar�owhar, pedar-e-�owhar
tch�n (otec �eny)	pedarzan, pedar-e-zan
tchyn�	m�dar-e-zan� m�dar-e-�owhar, m�darzan� m�dar�owhar
tchyn� (matka mu�e)	m�dar�owhar, m�dar-e-�owhar
tchyn� (matka �eny)	m�dar-e-zan, m�darzan
ti	beto
ticho	�r�m
t�lko	�ile
tis�c	hez�r
tisknout	c�p kardan
tkadlena	b�fandeh
tkanina	b�ft
tk�t	b�ftan
tleskat	�farin goftan, kaf zadan
tloustnout	c�q �odan
tlumo�it	tafsir kardan
tmav�	tirerang
tmav�	tire, t�rik
to	�n
to / je / ho (akuzativ)	�nr�
toaleta	tu�let, �r�ye�
toaletn� ta�ka / kabelka	ja'be ye abz�rh� ye �r�ye�
toastova� [toustova�]	tostkon
tob�	beto
tohle	in
tomu	be�n
topas	y�qut e zard
topaz	y�qut e zard
topen�	har�rat
topit	garm kardan
toto	in
tov�rna	k�rx�ne
tov�rn�k	k�rx�ned�r
trafika	tamb�kuforu�i
tramvaj	ter�mv�
transform�tor	tr�nsform�tor
transkripce	pacin
tr�vit (�as)	goza�tan
tren�r	rahbar e varze�i
trh	b�z�r
trhlina	�ek�f
tribuna	j�yeg�h
trochu	kami
trp�livost	sabr
trubka	�ipor
tr�n	taxt
trval� ondulace	fer
trv�n�	asr�r
tryskov� letadlo	hav�peym� ye jet
tr�nice	b�z�rce
t�e�e�	gil�s
t�et�	sevom
t�etina	som
t�i	se
t�i sta	sisad
t�icet	si
t�ikr�t	se b�r
t�in�ct	sizdah
tuba	lule
tucet	dojin
tu�n�	carb, c�q
tulip�n	l�le
tu��k	ton
turb�na	turbin
turista	turist
tu�ka	med�d
tvar	�ekl
tv��	cehre, gune, surat
tv�d	tuid
tvo�it	�faridan
tvrd�	saxt
tvrz	de�
tv�j	e to, -at
ty	to
t�den	hafte
tygr	babr
tykev	kadu ye mosamm�yi
tyrkys	firuze
u	bedaste, nazdik, dar ken�r, dame, darpahlu
ubrousek	dastm�l e sofre
uct�vat	paraste� kardan
u�ebnice	�muze�n�me
��et	hes�b
u�it se	�muxtan
u�itel	�muzg�r
udatnost	arvandi
ud�lal	karde'ast
ud�lal jsem	karde'am
ud�lal jsi	karde'i
ud�lali	karde'and
ud�lali jsme	karde'im
ud�lali jste	karde'id
�dol�	darreh, darre
udr�et	neg�h d�tan
uhel	zoq�l
uheln�	zoq�l
�hledn�	�r�ste
uhl�	zoq�l
uhl�k	k�rbon
ucho	gu�
ukr�st	dozdidan
�l	kandu
ulice	barzan, xy�b�n
uli�ka	kuceh
ultrafialov�	arqav�ni
um�lec	honarmand
um�l�	s�xtegi, masnu'i
um�n�	honar
um�t	balad budan, d�nestan
um�r�	mimirad
um�raj�	mimirand
um�r�m	mimiram
um�r�me	mimirim
um�r�	mimiri
um�r�te	mimirid
umo��ovat	momken kardan
um�vat	�ostan
�nava	xastegi ye far�v�n
univerzita	d�ne�g�h
�nor	fevrie
�pal	�ft�bzadagi
upozorn�n�	ext�r, tavajjoh
upozornit	barhazar kardan
�pravn�	�r�ste
up�ednost�ovat	tarjih d�dan
up��mn�	r�stnam�, p�k
upustit od	xod d�ri kardan
��ad	ed�re
�schovna zavazadel	amb�r e asb�bh� ye mos�ferin
�sta	dah�n
�stn� voda	dah�n�uy
�st�edn� topen�	dastg�h e har�rat markazi
u�n� kapky	qatre ye gu�
�ter�	se�anbe
�tes	partg�h
utk�n�	mos�beqe
utopit	qarq kardan
utopit se	qarq �odan
�vaha	fekr
�v�rov� karta	k�rt e e'teb�r
uv��it	b�var namudan
uvid�	x�had did
uvid� (pl.)	x�hand did
uvid�m	x�ham did
uvid�me	x�him did
uvid�	x�hi did
uvid�te	x�hid did
�vod	dib�ce
uzel	gere
uzen��	m�hi ye dudi
uzenka	sosis
uzen� sle�	m�hi ye dudi
�zk�	tang
��asn�	b�okuhi
��eh	�ft�bzadagi
v	dar
v pr�b�hu	hang�m
vagon	v�gon
v�ha	vazn, tar�zu
v�l�it	jangidan
v�lec (aut.)	silandr
v�le�n� n�mo�nictvo	niru ye dary�yi
v�lka	jang
v�m	be�om�
V�noce	Eyd e Mil�d e Masih
v�pno	�hak
varov�n�	ext�r
varovat	barhazar kardan
v�s	�om�r�
v�	e �om�, -etan
v�zanka	kr�v�t, dastm�l e gardan
vazel�na	v�zeline
v�n� hudba	musiqi ye kl�sik
v�era	diruz
v�era ve�er	di�ab
v�etn�	��mele
vd��n�	mota�akker
v�c	ciz
ve�er	�ab
ve�ern� �aty	leb�s e �ab
ve�e�e	��m
ve��rek	mehm�ni, p�rti
v��nost	zam�n e bikar�ne, bikar�ni, abadiyat
v��n�	bip�y�n, j�vd�ni, abadi
v�da	d�ne�
v�dec	d�ne�mand
v�d�l	d�nest
v�d�l jsem	d�nestam
v�d�l jsi	d�nesti
v�d�li	d�nestand
v�d�li jsme	d�nestim
v�d�li jste	d�nestid
v�d�t	d�nestan
v�d�	mid�nand
vedle	nazdik, pahlu, dar ken�r
vedouc�	modir
vedro	garm�
v�dy	olum
vejce	toxm
vej�t	andarun �odan
v�k	senn
velbloud	�otor
velice	besy�r, xeyli
velikost	and�ze
velik�	bozorg
velkom�sto	�ahr
velk�	bozorg
velmi	xeyli, besy�r
ven	birun
ventil	ventil
vep�edu	darjelow
vep�ov� (maso)	gu�t e xuk
v��it	gom�n kardan, b�var kardan
ves	deh
vesla�sk� �lun	q�yeq e p�ru zani
vesnice	dehk�de
v�st	rahbari kardan
vesta	�ile
v�ta	jomleh
v�tev	��xe
v�t��	bozorgtar
v�	borj
vchod	dar e vorud
v�	mid�nad
v�ce	bi�tar
vid�l	did
vid�l jsem	didam
vid�l jsi	didi
vid�li	didand
vid�li jsme	didim
vid�li jste	didid
vid�t	didan
vid�	mibinad
vid� (pl.)	mibinand
vid�m	mibinam
vid�me	mibinim
vid�	mibini
vid�te	mibinid
vidli�ka	cang�l
v�kend	p�y�n e hafte
v�la	pari
v�m	mid�nam
v�me	mid�nim
vinice	t�kest�n
vinohrad	t�kest�n
v�ra	gom�n, im�n, b�var
visa�ka	barcasb
v�	mid�ni
v�te	mid�nid
v�tejte	xo� �madid
v�tr	b�d
vlajka	parcam
vlak	qat�r
vlakov� n�dra��	istg�h e r�h e �han
vlakov� spojen�	qat�r e ettes�li
vlakov� j�zdn� ��d	barn�me ye harakat e qat�rh�
vlas	mu
vlast	vatan
vlastnictv�	m�lekiyat
vla�sk� o�ech	gerdu
vla�n�	velarm
vlk	gorg
vlna	pa�m
vloni	p�rs�l
vn�	birun
voda	�b
voda po holen�	losiyon e pas az ri� tar�i
vodop�d	�b��r
vodotrysk	fav�re
voj�k	sarb�z
vojsko	arte�, sep�h, la�gar
volnost	�z�di
voln�	x�li, �z�d
vo�avka	atr
vosa	zanbur
vousy	ri�
vp�ed	jelow
vp�edu	darjelow
vrak	l�e
vra�da	�damko�i
vrba	bid
vrtuln�k	helikopter
v�ed	domal, kurak
v�ed (�alud.)	zaxm e �ekam
v�el�	garm
vstoupit	andarun �odan
vstup	andarun, dar e vorud
vstupenka	belit
vstupenka na n�stupi�t�	belit e saku
vstupn� dve�e	dar e vorud
v�e	tam�m, hame, yeksare
v�echno	hame ciz, hame, hamegi
vte�ina	s�niye
v�dce	rahbar
v�le	er�de, er�dat, �rzu
v�n�	bu
vu�t	sosis
v�z	v�gon
vy	�om�
v�born�	�li
vy�erpanost	xastegi ye far�v�n
v�dejna j�zdenek	b�je ye foru� e belit
vyd�r�n�	b�j
vyd�rat	b�j gereftan
vyhl�ka	tavajjoh
v�hoda	sud, estef�de, bahrevari
v�hodnost	bahrevari
vyhr�t	barande �odan
vyhrazen�	rezerv �ode
v�chod	xor�s�n, xoruj, x�var
v�chod (dve�e)	dar e xoruj
v�chodn�	xor�s�n
vychutn�vat	lezzat bordan
vyj�d�en� akuzativu	r�
vyj�d�en� dativu	be
vyj�d�en� genitivu	e
v�jezd	xoruj
v�jezdn�	xoruj
v�kladn� sk���	vitrin e maq�ze
v�kres	k�qaz e naqq�i
vylekan�	tarside
vylekat	tars�ndan
vyl�zt	birun xazidan
v�loha	vitrin e maq�ze
vymy�len�	s�xtegi
v��atek	xol�se
vyndat	dar �vardan
vynd�vat	dar �vardan
vynikaj�c�	�li
vyp�lit	�ta� zadan
v�pary	bex�r�t
vyp�stovat	k�tan
vyp�nat	x�mu� kardan
vypl�chnout	b�'�b �ostan
vypl�ovat	por kardan
vypnout	x�mu� kardan
vypravovat	goftan
vyprod�no	foru�rafte
v�robek	s�xte
v�ro��	s�lgard
v�rok	azh�r
v�slovnost	talaffoz
vyslovovat	ad� kardan
vysok� �kola	d�ne�g�h
vysok�	boland
vysou�e� vlas�	muxo�kkon
vysp�lost	mehtari, born�yi
v�stava	nam�ye�g�h
v�straha	ext�r
vystra�en�	tarside
v�tah	�s�nsor
vyt�p�n�	har�rat
v�var	�bgu�t
vyvolat	birun ka�idan, far�x�ndan
vyzkou�et	emteh�n kardan
vyzn�n�	mezhab
vzadu	dirtar az, po�te sar
vzduch	hav�
vz�t si	gereftan, bordan
v�dy	hami�e
WC	tu�let
z	x�mu�, jod�, az, durtar
z druh� ruky (second hand)	dast e dovom
za	bar�ye inke, po�te sar, darpey, po�t, dirtar az
za (trv�n�)	hang�m
zabalit	picidan
z�bava	sargami
z�blesk	nur e kam
za��tek	ebted�
za��nat	�q�z kardan
za��t	�q�z namudan
z�� (m�sto vzadu)	ne�imang�h
z�da	po�t
zahrada	b�q
zahr�dka	baqce
zahradn�	b�qi
z�chod	tu�let
zachov�vat	neg�h d�tan
z�chrana	nej�t
zaj�c	xargu� e sahr�yi
z�kaz	b�zd�ri
z�kaz zastaven�	tavaqqof mamnu
zak�zan�	mamnu
z�kaznictvo	gomrok
z�kon	q�nun
z�kusek	keyk
z�liv	xalij
z�mek	k�x
zamilovan�	kere�me
z�n�t	elteh�b
z�n�t kloub�	b�d e maf�sel
z�pad	b�xtar
z�pach	bu ye bad
z�pal	elteh�b
z�pal plic	sinepahlu
zapalova�	fandak
zapalov�n�	girboks
z�pas	mos�beqe
z�p�st�	moc
z�pisn�k	daftarce
Zarathu�tra	Zarto�t
z���	sept�mbr
zas�hnout	asar kardan
z�sobit palivem	suxtgiri kardan
zastav	neg�h d�r
z�stava	parcam
zastaven�	tavaqqof
zast�vka	ist
zastavovat	neg�h d�tan
z�syp (kosmetick�)	kerempudr
zat�m	hanuz
zatm�n� slunce	�ft�bgereftegi
zavazadlo	j�med�n, asb�b, b�r e safar
zav�r�	mibandad
zav�raj�	mibandand
zav�ral	mibast
zav�ral jsem	minbastam, mibastam
zav�ral jsi	minbasti, mibasti
zav�rali	mibastand
zav�rali jsme	mibastim
zav�rali jste	mibastid
zav�r�m	mibandam
zav�r�me	mibandim
zav�r�	mibandi
zav�rat	bastan
zav�r�te	mibandid
zav�el	bast
zav�el jsem	bastam
zav�el jsi	basti
zav�eli	bastand
zav�eli jsme	bastim
zav�eli jste	bastid
zav�en�	baste
z�eh	barfak, girboks
za��vac� pot�e	badgov�re�i
zb�t	zadan
zbo��ovat	parastidan
zbytek	b�qi
zd�t se	x�b didan, namudan, nemudan
zde	inj�
zdr�hat se	bad d�nestan
zdrav�	h�l
zdravotn� st�edisko	darm�ng�h
zdrhovadlo	zip
zdr�et se	xod d�ri kardan
zdvi�	�s�nsor
zelen� fazole	lubiy� ye sabz
zelenina	sabzi
zelen�	sabz
zel�	kalampic
zem�	zamin
zem� st�t	ke�var
zem�pis	joqr�fiy�
zem�t�esen�	zaminlarze
zem�el	mord
zem�el jsem	mordam
zem�el jsi	mordi
zem�eli	mordand
zem�eli jsme	mordim
zem�eli jste	mordid
zem��t	mordan
zesilova�	bolandgu
ze�	d�m�d
zima	zemest�n
zinek	ruy
zip	zip
zisk	f�yede
z�tra	fard�
zkou�ka	�zm�ye�
zkrachoval�	var�ekaste
zkrotit	sarkubi kardan, forune��ndan
zkusit	�zmudan
zlat�	zarrin
zlato	zar
zlep�it	behtar nemudan
zlod�j	dozd
zlomit	�ekastan
zlost	xa�m
zl�	�arir, �um, ziy�n�var, bad
zmrzlina	bastani
znak	al�mat
znalec	k�rd�n
znalost	d�ne�
znamen�	ne��ne
znam�nko	al�mat
zn�mka	tambr e post
zn�t	d�nestan, �en�xtan
zn�val	mid�nest
zn�val jsem	mid�nestam
zn�val jsi	mid�nesti
zn�vali	mid�nestand
zn�vali jsme	mid�nestim
zn�vali jste	mid�nestid
znovu	b�z, dob�re
zoo	dad�nb�q, b�q e vah�
zoologick� zahrada	b�q e vah�, dad�nb�q
zoologie	j�nvar�en�si
Zoroaster	Zarto�t
zp�v	sorud
zp�vat	sar�yidan, x�ndan, �v�z x�ndan
zpod	azzir, zirin
zpo�d�n�	taxir
zranit	�sib ras�ndan
zrn�	d�ne
zrno	d�ne
ztr�cet	gom kardan
zub	dand�n
zuba�	dand�npeze�k
zubn� kart��ek	dand�n�uy
zubn� l�ka�	dand�npeze�k
zubn� pasta	xamir e dand�n
z�stat	m�nidan
zv�it	vazn kardan
zv�t�zit	barande �odan
zvl�tn�	vi�e, s�xtegi
zvon	zang
zvonek	zangole
zvonit	zang zadan
zvrhl�	f�sad
zvu�n�	sed�d�r
zvuk	sed�
zvukov�	�v�d�r
zvyk	�dab
� (hl�ska)	� (horuf)
��dn�	hic
��k	d�ne��muz
��kovsk�	d�ne��muzi
��kyn�	��gard
�aloba	�ek�yat
��r	t�be�
��rovka	l�mp
�e	ke
�ebro	dande
�ehli�ka	otu
�ehnat	barekat d�dan, ya�tan, b�lestan
�elatina	�el�tin
�elez��stv�	�hanforu�i
�elezit�	�hani
�elezni�n� stanice	istg�h e r�h e �han
�elezn�	�hani
�elezo	�han
�ena	zan
�ensk�	zan�ne
�enstv�	zan�negi
�id	yahudi
�idle	sandali
��la	siy�hrag
�iletka	xodtar�, tiq
��nka	espanj
�irafa	zarrafe
��t	zistan
�ivot	j�n, zendegi, hay�t
�iv�	zende
��zniv�	te�ne
�l�za	qodde
�lu�	zahre, zard�b
�lutohn�d�	zard e kamrang
�lut�	zard
�ol�k	�oker
�upan	kot e x�negi

All rights reserved. � 2002 Libor Sztemon, Hav��ov
E-mail: 108216514+libor-sztemon@users.noreply.github.com; http://www.sweb.cz/ls78/libor.htm